AAAAAACCTGCGGACACCT -> AAAAACCTGCGGACACCTA
AAAAACCTGCGGACACCTA -> AAAACCTGCGGACACCTAC
AAAAATTTTTGTCCTCCGA -> AAAATTTTTGTCCTCCGAC
AAAACCTGCGGACACCTAC -> AAACCTGCGGACACCTACC
AAAAGACTGATAGCCGGTC -> AAAGACTGATAGCCGGTCA
AAAAGGCTCACTGTGCCAT -> AAAGGCTCACTGTGCCATG
AAAAGGGGGAAGGAGTACA -> AAAGGGGGAAGGAGTACAA
AAAAGGTACAAGCATACGC -> AAAGGTACAAGCATACGCC
AAAATAAATATATCCAAAG -> AAATAAATATATCCAAAGC
AAAATTTTTGTCCTCCGAC -> AAATTTTTGTCCTCCGACC
AAACAGCCCAACATTATTT -> AACAGCCCAACATTATTTT
AAACCACGCTGCTAAAAAA -> AACCACGCTGCTAAAAAAC
AAACCTGCGGACACCTACC -> AACCTGCGGACACCTACCT
AAACGAAGGCATTCAAGAG -> AACGAAGGCATTCAAGAGC
AAACGGACCGTTGGGCGGT -> AACGGACCGTTGGGCGGTG
AAACTAAGGCGTCTAAGGC -> AACTAAGGCGTCTAAGGCC
AAACTAGTCGCCGTTTTCT -> AACTAGTCGCCGTTTTCTT
AAACTTAAGGGAGGTGAGC -> AACTTAAGGGAGGTGAGCT
AAAGACATTGGCACAACTC -> AAGACATTGGCACAACTCA
AAAGACTGATAGCCGGTCA -> AAGACTGATAGCCGGTCAA
AAAGCAATAAATGTACGGC -> AAGCAATAAATGTACGGCG
AAAGCGGGAAAAGGCTCAC -> AAGCGGGAAAAGGCTCACT
AAAGGAATCAGACCCCAGA -> AAGGAATCAGACCCCAGAG
AAAGGCGGGTTTCGACACA -> AAGGCGGGTTTCGACACAA
AAAGGCTCACTGTGCCATG -> AAGGCTCACTGTGCCATGG
AAAGGGGGAAGGAGTACAA -> AAGGGGGAAGGAGTACAAT
AAAGGTACAAGCATACGCC -> AAGGTACAAGCATACGCCG
AAAGTAAACTAGTCGCCGT -> AAGTAAACTAGTCGCCGTT
AAAGTGCCGCCAACCACGT -> AAGTGCCGCCAACCACGTT
AAATAAATATATCCAAAGC -> AATAAATATATCCAAAGCG
AAATATATCCAAAGCGGGA -> AATATATCCAAAGCGGGAA
AAATCGAGCACTCCGGGCT -> AATCGAGCACTCCGGGCTT
AAATGTACGGCGCGTCCGC -> AATGTACGGCGCGTCCGCG
AAATTTTTGTCCTCCGACC -> AATTTTTGTCCTCCGACCT
AACAATGATCGGGTGCAAT -> ACAATGATCGGGTGCAATG
AACAGCCCAACATTATTTT -> ACAGCCCAACATTATTTTA
AACAGCCGATTTCGAGCAT -> ACAGCCGATTTCGAGCATG
AACATTATTTTAACAATGA -> ACATTATTTTAACAATGAT
AACATTTCATACCGATTTC -> ACATTTCATACCGATTTCG
AACCAAGACCTATGCGTAG -> ACCAAGACCTATGCGTAGT
AACCACGCTGCTAAAAAAC -> ACCACGCTGCTAAAAAACC
AACCACGTTGGACCGGGTA -> ACCACGTTGGACCGGGTAG
AACCAGAACAGCCGATTTC -> ACCAGAACAGCCGATTTCG
AACCATAGGAGCCTGACAC -> ACCATAGGAGCCTGACACC
AACCATTAATTTACGCCGA -> ACCATTAATTTACGCCGAG
AACCGAATTTTCATATGGC -> ACCGAATTTTCATATGGCA
AACCGCAGGTAACCTAGGT -> ACCGCAGGTAACCTAGGTG
AACCTAGGTGTGGGTAAAC -> ACCTAGGTGTGGGTAAACT
AACCTGCGGACACCTACCT -> ACCTGCGGACACCTACCTA
AACGAAGGCATTCAAGAGC -> ACGAAGGCATTCAAGAGCC
AACGAAGGCCTGTGGAGGC -> ACGAAGGCCTGTGGAGGCC
AACGAGATGAAGATCCAGC -> ACGAGATGAAGATCCAGCC
AACGCCGGGAGAGGTCCGA -> ACGCCGGGAGAGGTCCGAC
AACGGACCGTTGGGCGGTG -> ACGGACCGTTGGGCGGTGT
AACGGCAATGACTGGAATG -> ACGGCAATGACTGGAATGC
AACGGGCTTGTGCATAAGG -> ACGGGCTTGTGCATAAGGG
AACGGTCCGAACCAGAACA -> ACGGTCCGAACCAGAACAG
AACGTGGTCAGACACCATT -> ACGTGGTCAGACACCATTA
AACGTTGCTTCCAGACATC -> ACGTTGCTTCCAGACATCG
AACTAAAGGAATCAGACCC -> ACTAAAGGAATCAGACCCC
AACTAAGGCGTCTAAGGCC -> ACTAAGGCGTCTAAGGCCC
AACTAGGGAGGCCGAGCAC -> ACTAGGGAGGCCGAGCACG
AACTAGTCGCCGTTTTCTT -> ACTAGTCGCCGTTTTCTTG
AACTCAGGTAGTGGCTAAA -> ACTCAGGTAGTGGCTAAAA
AACTCTTCTCGGGCGATTG -> ACTCTTCTCGGGCGATTGC
AACTGCTCGAACTAAAGGA -> ACTGCTCGAACTAAAGGAA
AACTGTCGAGATGCGCTGC -> ACTGTCGAGATGCGCTGCA
AACTTAAGGGAGGTGAGCT -> ACTTAAGGGAGGTGAGCTA
AACTTAATGCGCAACGGTC -> ACTTAATGCGCAACGGTCC
AACTTCCTTGCGCTACGCT -> ACTTCCTTGCGCTACGCTC
AACTTGAGGTTTGCTGTCG -> ACTTGAGGTTTGCTGTCGA
AAGAAGCATTCTATACAAG -> AGAAGCATTCTATACAAGT
AAGAAGCGTTGATCGTACC -> AGAAGCGTTGATCGTACCG
AAGACACCGTCTCAACTTG -> AGACACCGTCTCAACTTGA
AAGACATTGGCACAACTCA -> AGACATTGGCACAACTCAG
AAGACCTATGCGTAGTTTA -> AGACCTATGCGTAGTTTAT
AAGACGAAAGTAAACTAGT -> AGACGAAAGTAAACTAGTC
AAGACTGATAGCCGGTCAA -> AGACTGATAGCCGGTCAAC
AAGAGCCCGCAGCCCATCG -> AGAGCCCGCAGCCCATCGT
AAGATCCAGCCCCATTACC -> AGATCCAGCCCCATTACCA
AAGCAATAAATGTACGGCG -> AGCAATAAATGTACGGCGC
AAGCACTTCCGAGACTACT -> AGCACTTCCGAGACTACTT
AAGCATACGCCGTAAATCG -> AGCATACGCCGTAAATCGA
AAGCATAGACCAAGGCTGT -> AGCATAGACCAAGGCTGTC
AAGCATTCTATACAAGTGA -> AGCATTCTATACAAGTGAG
AAGCGGGAAAAGGCTCACT -> AGCGGGAAAAGGCTCACTG
AAGCGTTGATCGTACCGTC -> AGCGTTGATCGTACCGTCT
AAGGAAGACGAAAGTAAAC -> AGGAAGACGAAAGTAAACT
AAGGAATCAGACCCCAGAG -> AGGAATCAGACCCCAGAGA
AAGGAGTACAATACACGCC -> AGGAGTACAATACACGCCT
AAGGATTAGGCTGTTGAAC -> AGGATTAGGCTGTTGAACT
AAGGCATTCAAGAGCCCGC -> AGGCATTCAAGAGCCCGCA
AAGGCCCGACCTGACGTAG -> AGGCCCGACCTGACGTAGA
AAGGCCTGTGGAGGCCCTA -> AGGCCTGTGGAGGCCCTAC
AAGGCGGGTTTCGACACAA -> AGGCGGGTTTCGACACAAT
AAGGCGTAATGACTTCAAA -> AGGCGTAATGACTTCAAAG
AAGGCGTCTAAGGCCCGAC -> AGGCGTCTAAGGCCCGACC
AAGGCTCACTGTGCCATGG -> AGGCTCACTGTGCCATGGA
AAGGCTGTCAGCGTTGCGT -> AGGCTGTCAGCGTTGCGTA
AAGGGAGGTGAGCTACTGA -> AGGGAGGTGAGCTACTGAA
AAGGGCGCTCGCAGGCCGC -> AGGGCGCTCGCAGGCCGCA
AAGGGGGAAGGAGTACAAT -> AGGGGGAAGGAGTACAATA
AAGGGTATTGAGGTGCTTT -> AGGGTATTGAGGTGCTTTC
AAGGTACAAGCATACGCCG -> AGGTACAAGCATACGCCGT
AAGGTGGCCTTACATTCAT -> AGGTGGCCTTACATTCATC
AAGTAAACTAGTCGCCGTT -> AGTAAACTAGTCGCCGTTT
AAGTACGGGAACGCCGGGA -> AGTACGGGAACGCCGGGAG
AAGTACGGTGCAGCTAGCG -> AGTACGGTGCAGCTAGCGT
AAGTCGATACCTGCAGGGT -> AGTCGATACCTGCAGGGTA
AAGTCGCTAGTACCTACAG -> AGTCGCTAGTACCTACAGT
AAGTGAGGTGTCCCTTCCG -> AGTGAGGTGTCCCTTCCGA
AAGTGAGTGGGAAGTACGG -> AGTGAGTGGGAAGTACGGT
AAGTGCCGCCAACCACGTT -> AGTGCCGCCAACCACGTTG
AATAAATATATCCAAAGCG -> ATAAATATATCCAAAGCGG
AATAAATGTACGGCGCGTC -> ATAAATGTACGGCGCGTCC
AATAAGTCGCTAGTACCTA -> ATAAGTCGCTAGTACCTAC
AATACACGCCTAGTTCTGG -> ATACACGCCTAGTTCTGGA
AATATATCCAAAGCGGGAA -> ATATATCCAAAGCGGGAAA
AATCAACTTCCTTGCGCTA -> ATCAACTTCCTTGCGCTAC
AATCAGACCCCAGAGATTA -> ATCAGACCCCAGAGATTAA
AATCGAGCACTCCGGGCTT -> ATCGAGCACTCCGGGCTTG
AATCTGGACGGATCCTGCC -> ATCTGGACGGATCCTGCCT
AATGACTGGAATGCATCTT -> ATGACTGGAATGCATCTTA
AATGACTTCAAAGACATTG -> ATGACTTCAAAGACATTGG
AATGAGAAGTGAGGTGTCC -> ATGAGAAGTGAGGTGTCCC
AATGATCGGGTGCAATGTT -> ATGATCGGGTGCAATGTTC
AATGCATCTTAACGGGCTT -> ATGCATCTTAACGGGCTTG
AATGCGCAACGGTCCGAAC -> ATGCGCAACGGTCCGAACC
AATGGCCGGCCGGGAACAT -> ATGGCCGGCCGGGAACATT
AATGGCTGTAGGATACAGT -> ATGGCTGTAGGATACAGTC
AATGGTAAACAGCCCAACA -> ATGGTAAACAGCCCAACAT
AATGTACGGCGCGTCCGCG -> ATGTACGGCGCGTCCGCGT
AATGTTCCTAGCCCGGTCT -> ATGTTCCTAGCCCGGTCTC
AATTACTGAAGGATTAGGC -> ATTACTGAAGGATTAGGCT
AATTCGACGGGGTCGGGCG -> ATTCGACGGGGTCGGGCGA
AATTCTAGATTCCCAGGAC -> ATTCTAGATTCCCAGGACG
AATTGTGTCCGGAAGCATA -> ATTGTGTCCGGAAGCATAG
AATTTACGCCGAGCTCCTC -> ATTTACGCCGAGCTCCTCC
AATTTTCATATGGCAATGA -> ATTTTCATATGGCAATGAG
AATTTTTGTCCTCCGACCT -> ATTTTTGTCCTCCGACCTA
ACAAAAGACTGATAGCCGG -> CAAAAGACTGATAGCCGGT
ACAAACGGACCGTTGGGCG -> CAAACGGACCGTTGGGCGG
ACAACCAAGACCTATGCGT -> CAACCAAGACCTATGCGTA
ACAACGGCAATGACTGGAA -> CAACGGCAATGACTGGAAT
ACAACGTGGTCAGACACCA -> CAACGTGGTCAGACACCAT
ACAACTCAGGTAGTGGCTA -> CAACTCAGGTAGTGGCTAA
ACAAGCACTTCCGAGACTA -> CAAGCACTTCCGAGACTAC
ACAAGCATACGCCGTAAAT -> CAAGCATACGCCGTAAATC
ACAAGTGAGTGGGAAGTAC -> CAAGTGAGTGGGAAGTACG
ACAATACACGCCTAGTTCT -> CAATACACGCCTAGTTCTG
ACAATGATCGGGTGCAATG -> CAATGATCGGGTGCAATGT
ACAATGGCTGTAGGATACA -> CAATGGCTGTAGGATACAG
ACACAAGCACTTCCGAGAC -> CACAAGCACTTCCGAGACT
ACACAATGGCTGTAGGATA -> CACAATGGCTGTAGGATAC
ACACCATTACTTTAGCTCG -> CACCATTACTTTAGCTCGG
ACACCGTCGTGCCCTGGTT -> CACCGTCGTGCCCTGGTTA
ACACCGTCTCAACTTGAGG -> CACCGTCTCAACTTGAGGT
ACACCTACCTACGTTGTCA -> CACCTACCTACGTTGTCAG
ACACGCCTAGTTCTGGACG -> CACGCCTAGTTCTGGACGG
ACACGGTCGGCTTCTCTGT -> CACGGTCGGCTTCTCTGTC
ACACGTTTAAGGCGTAATG -> CACGTTTAAGGCGTAATGA
ACACTATCTGACATATAGC -> CACTATCTGACATATAGCA
ACACTGATACTAGCAGGGC -> CACTGATACTAGCAGGGCT
ACACTTACACGGTCGGCTT -> CACTTACACGGTCGGCTTC
ACAGATCAGTCCATTTATT -> CAGATCAGTCCATTTATTA
ACAGATCGTGGTCCTTCCC -> CAGATCGTGGTCCTTCCCA
ACAGCCCAACATTATTTTA -> CAGCCCAACATTATTTTAA
ACAGCCGATTTCGAGCATG -> CAGCCGATTTCGAGCATGT
ACAGCGCGCGGCTCTGAGG -> CAGCGCGCGGCTCTGAGGC
ACAGCGCTAACTTAATGCG -> CAGCGCTAACTTAATGCGC
ACAGGATATGATTTGACTC -> CAGGATATGATTTGACTCC
ACAGTCGACCTCTCAACGT -> CAGTCGACCTCTCAACGTT
ACAGTTACCGATCTGCCGG -> CAGTTACCGATCTGCCGGG
ACATATAGCACGCAAAAGG -> CATATAGCACGCAAAAGGG
ACATCGTAGGTTGATTTGA -> CATCGTAGGTTGATTTGAG
ACATTATTTTAACAATGAT -> CATTATTTTAACAATGATC
ACATTCATCCCTCAACCAT -> CATTCATCCCTCAACCATA
ACATTGGCACAACTCAGGT -> CATTGGCACAACTCAGGTA
ACATTTCATACCGATTTCG -> CATTTCATACCGATTTCGA
ACCAAGACCTATGCGTAGT -> CCAAGACCTATGCGTAGTT
ACCAAGGCTGTCAGCGTTG -> CCAAGGCTGTCAGCGTTGC
ACCAAGGGCGCTCGCAGGC -> CCAAGGGCGCTCGCAGGCC
ACCAATCAACTTCCTTGCG -> CCAATCAACTTCCTTGCGC
ACCACGCTGCTAAAAAACC -> CCACGCTGCTAAAAAACCT
ACCACGTTGGACCGGGTAG -> CCACGTTGGACCGGGTAGC
ACCAGAACAGCCGATTTCG -> CCAGAACAGCCGATTTCGA
ACCATAGGAGCCTGACACC -> CCATAGGAGCCTGACACCG
ACCATCAACCGCAGGTAAC -> CCATCAACCGCAGGTAACC
ACCATCAACGAAGGCCTGT -> CCATCAACGAAGGCCTGTG
ACCATCAACTCTTCTCGGG -> CCATCAACTCTTCTCGGGC
ACCATCAACTGCTCGAACT -> CCATCAACTGCTCGAACTA
ACCATTAATTTACGCCGAG -> CCATTAATTTACGCCGAGC
ACCATTACTTTAGCTCGGC -> CCATTACTTTAGCTCGGCT
ACCCCAGAGATTAATTACT -> CCCCAGAGATTAATTACTG
ACCCGCCCTTCGGATAAAA -> CCCGCCCTTCGGATAAAAG
ACCCTGCAAAGGCGGGTTT -> CCCTGCAAAGGCGGGTTTC
ACCGAATTTTCATATGGCA -> CCGAATTTTCATATGGCAA
ACCGATCTGCCGGGCCCAG -> CCGATCTGCCGGGCCCAGG
ACCGATTTCGAGCATGTAC -> CCGATTTCGAGCATGTACA
ACCGCAGGTAACCTAGGTG -> CCGCAGGTAACCTAGGTGT
ACCGGGTAGCGGTCCCACA -> CCGGGTAGCGGTCCCACAC
ACCGTCGTGCCCTGGTTAT -> CCGTCGTGCCCTGGTTATG
ACCGTCTCAACTTGAGGTT -> CCGTCTCAACTTGAGGTTT
ACCGTCTTCGCCATTATTG -> CCGTCTTCGCCATTATTGC
ACCGTTGGGCGGTGTACCA -> CCGTTGGGCGGTGTACCAT
ACCTACAGTTACCGATCTG -> CCTACAGTTACCGATCTGC
ACCTACCTACGTTGTCAGC -> CCTACCTACGTTGTCAGCA
ACCTACGTTGTCAGCACCC -> CCTACGTTGTCAGCACCCG
ACCTAGAGGGAATGGTAAA -> CCTAGAGGGAATGGTAAAC
ACCTAGGTGTGGGTAAACT -> CCTAGGTGTGGGTAAACTT
ACCTATGCGTAGTTTATCC -> CCTATGCGTAGTTTATCCG
ACCTCTCAACGTTGCTTCC -> CCTCTCAACGTTGCTTCCA
ACCTGACGTAGAAGAAGCA -> CCTGACGTAGAAGAAGCAT
ACCTGCAGGGTATCCAAGA -> CCTGCAGGGTATCCAAGAA
ACCTGCGGACACCTACCTA -> CCTGCGGACACCTACCTAC
ACCTTGTCTGTGGTGGGCG -> CCTTGTCTGTGGTGGGCGG
ACGAAAGTAAACTAGTCGC -> CGAAAGTAAACTAGTCGCC
ACGAAGGCATTCAAGAGCC -> CGAAGGCATTCAAGAGCCC
ACGAAGGCCTGTGGAGGCC -> CGAAGGCCTGTGGAGGCCC
ACGAGACTTCCTGTGTTGC -> CGAGACTTCCTGTGTTGCC
ACGAGATGAAGATCCAGCC -> CGAGATGAAGATCCAGCCC
ACGAGTTTTAGCCGCGGGC -> CGAGTTTTAGCCGCGGGCA
ACGATACGTGGGCGGTGTA -> CGATACGTGGGCGGTGTAC
ACGCAAAAGGGGGAAGGAG -> CGCAAAAGGGGGAAGGAGT
ACGCCGAGCTCCTCCGGAA -> CGCCGAGCTCCTCCGGAAA
ACGCCGGCCAAGGTGGCCT -> CGCCGGCCAAGGTGGCCTT
ACGCCGGGAGAGGTCCGAC -> CGCCGGGAGAGGTCCGACA
ACGCCGTAAATCGAGCACT -> CGCCGTAAATCGAGCACTC
ACGCCTAGTTCTGGACGGC -> CGCCTAGTTCTGGACGGCC
ACGCTACGATACGTGGGCG -> CGCTACGATACGTGGGCGG
ACGCTCACAGCGCGCGGCT -> CGCTCACAGCGCGCGGCTC
ACGCTGCTAAAAAACCTGC -> CGCTGCTAAAAAACCTGCG
ACGGACCGTTGGGCGGTGT -> CGGACCGTTGGGCGGTGTA
ACGGACGAGTTTTAGCCGC -> CGGACGAGTTTTAGCCGCG
ACGGATCCTGCCTAGTGTA -> CGGATCCTGCCTAGTGTAA
ACGGCAATGACTGGAATGC -> CGGCAATGACTGGAATGCA
ACGGCCTTGCAGAGCTTCG -> CGGCCTTGCAGAGCTTCGC
ACGGCGCGTCCGCGTCCTG -> CGGCGCGTCCGCGTCCTGG
ACGGGAACGCCGGGAGAGG -> CGGGAACGCCGGGAGAGGT
ACGGGCATATACAGCGCTA -> CGGGCATATACAGCGCTAA
ACGGGCTTGTGCATAAGGG -> CGGGCTTGTGCATAAGGGT
ACGGGGTCGGGCGATGCTC -> CGGGGTCGGGCGATGCTCC
ACGGGTGATTGACCTTCGT -> CGGGTGATTGACCTTCGTT
ACGGTCCGAACCAGAACAG -> CGGTCCGAACCAGAACAGC
ACGGTCGGCTTCTCTGTCC -> CGGTCGGCTTCTCTGTCCA
ACGGTGCAGCTAGCGTAAT -> CGGTGCAGCTAGCGTAATC
ACGTAGAAGAAGCATTCTA -> CGTAGAAGAAGCATTCTAT
ACGTGCGGGACAGATCGTG -> CGTGCGGGACAGATCGTGG
ACGTGGGCGGTGTACCATC -> CGTGGGCGGTGTACCATCA
ACGTGGTCAGACACCATTA -> CGTGGTCAGACACCATTAC
ACGTTGCTTCCAGACATCG -> CGTTGCTTCCAGACATCGT
ACGTTGGACCGGGTAGCGG -> CGTTGGACCGGGTAGCGGT
ACGTTGTCAGCACCCGCCC -> CGTTGTCAGCACCCGCCCT
ACGTTTAAGGCGTAATGAC -> CGTTTAAGGCGTAATGACT
ACTAAAGGAATCAGACCCC -> CTAAAGGAATCAGACCCCA
ACTAAGGCGTCTAAGGCCC -> CTAAGGCGTCTAAGGCCCG
ACTACTTCACAACGGCAAT -> CTACTTCACAACGGCAATG
ACTAGCAGGGCTGGGCCTA -> CTAGCAGGGCTGGGCCTAA
ACTAGGGAGGCCGAGCACG -> CTAGGGAGGCCGAGCACGG
ACTAGTCGCCGTTTTCTTG -> CTAGTCGCCGTTTTCTTGG
ACTATCTGACATATAGCAC -> CTATCTGACATATAGCACG
ACTATGAAGACACCGTCTC -> CTATGAAGACACCGTCTCA
ACTCAGGTAGTGGCTAAAA -> CTCAGGTAGTGGCTAAAAT
ACTCCCCTATGTATCTATA -> CTCCCCTATGTATCTATAG
ACTCCGGGCTTGCTCTGCA -> CTCCGGGCTTGCTCTGCAC
ACTCGCGCTAGATTCCAAT -> CTCGCGCTAGATTCCAATG
ACTCGCTGCAGCTGAAAGT -> CTCGCTGCAGCTGAAAGTG
ACTCTTACAACGTGGTCAG -> CTCTTACAACGTGGTCAGA
ACTCTTCTCGGGCGATTGC -> CTCTTCTCGGGCGATTGCG
ACTGAAGGATTAGGCTGTT -> CTGAAGGATTAGGCTGTTG
ACTGAATAAGTCGCTAGTA -> CTGAATAAGTCGCTAGTAC
ACTGATACTAGCAGGGCTG -> CTGATACTAGCAGGGCTGG
ACTGATAGCCGGTCAACCA -> CTGATAGCCGGTCAACCAT
ACTGCTCGAACTAAAGGAA -> CTGCTCGAACTAAAGGAAT
ACTGGAATGCATCTTAACG -> CTGGAATGCATCTTAACGG
ACTGTCGAGATGCGCTGCA -> CTGTCGAGATGCGCTGCAC
ACTGTGCCATGGATGATAC -> CTGTGCCATGGATGATACG
ACTTAAGGGAGGTGAGCTA -> CTTAAGGGAGGTGAGCTAC
ACTTAATGCGCAACGGTCC -> CTTAATGCGCAACGGTCCG
ACTTACACGGTCGGCTTCT -> CTTACACGGTCGGCTTCTC
ACTTCAAAGACATTGGCAC -> CTTCAAAGACATTGGCACA
ACTTCACAACGGCAATGAC -> CTTCACAACGGCAATGACT
ACTTCATGGCATCTGGCAG -> CTTCATGGCATCTGGCAGT
ACTTCCGAGACTACTTCAC -> CTTCCGAGACTACTTCACA
ACTTCCTGTGTTGCCCCCG -> CTTCCTGTGTTGCCCCCGA
ACTTCCTTGCGCTACGCTC -> CTTCCTTGCGCTACGCTCA
ACTTGAGGTTTGCTGTCGA -> CTTGAGGTTTGCTGTCGAA
ACTTGATAGCGGTTGGGCG -> CTTGATAGCGGTTGGGCGG
ACTTTAGCTCGGCTCCGAT -> CTTTAGCTCGGCTCCGATT
AGAACAGCCGATTTCGAGC -> GAACAGCCGATTTCGAGCA
AGAAGAAGCATTCTATACA -> GAAGAAGCATTCTATACAA
AGAAGCATTCTATACAAGT -> GAAGCATTCTATACAAGTG
AGAAGCGTTGATCGTACCG -> GAAGCGTTGATCGTACCGT
AGAAGTGAGGTGTCCCTTC -> GAAGTGAGGTGTCCCTTCC
AGACACCATTACTTTAGCT -> GACACCATTACTTTAGCTC
AGACACCGTCTCAACTTGA -> GACACCGTCTCAACTTGAG
AGACATCGTAGGTTGATTT -> GACATCGTAGGTTGATTTG
AGACATTGGCACAACTCAG -> GACATTGGCACAACTCAGG
AGACCAAGGCTGTCAGCGT -> GACCAAGGCTGTCAGCGTT
AGACCCCAGAGATTAATTA -> GACCCCAGAGATTAATTAC
AGACCTATGCGTAGTTTAT -> GACCTATGCGTAGTTTATC
AGACGAAAGTAAACTAGTC -> GACGAAAGTAAACTAGTCG
AGACTACTTCACAACGGCA -> GACTACTTCACAACGGCAA
AGACTGATAGCCGGTCAAC -> GACTGATAGCCGGTCAACC
AGACTTCCTGTGTTGCCCC -> GACTTCCTGTGTTGCCCCC
AGAGATTAATTACTGAAGG -> GAGATTAATTACTGAAGGA
AGAGCCCGCAGCCCATCGT -> GAGCCCGCAGCCCATCGTA
AGAGCTTCGCCACCAATCA -> GAGCTTCGCCACCAATCAA
AGAGGGAATGGTAAACAGC -> GAGGGAATGGTAAACAGCC
AGAGGTCCGACACTATCTG -> GAGGTCCGACACTATCTGA
AGAGTATCGAAGTACGGGA -> GAGTATCGAAGTACGGGAA
AGATCAGTCCATTTATTAG -> GATCAGTCCATTTATTAGA
AGATCCAGCCCCATTACCA -> GATCCAGCCCCATTACCAA
AGATCGTGGTCCTTCCCAC -> GATCGTGGTCCTTCCCACT
AGATGAAGATCCAGCCCCA -> GATGAAGATCCAGCCCCAT
AGATGCGCTGCACAACCAA -> GATGCGCTGCACAACCAAG
AGATTAATTACTGAAGGAT -> GATTAATTACTGAAGGATT
AGATTCCAATGGCCGGCCG -> GATTCCAATGGCCGGCCGG
AGATTCCCAGGACGGGCAT -> GATTCCCAGGACGGGCATA
AGCAATAAATGTACGGCGC -> GCAATAAATGTACGGCGCG
AGCACCCGCCCTTCGGATA -> GCACCCGCCCTTCGGATAA
AGCACGCAAAAGGGGGAAG -> GCACGCAAAAGGGGGAAGG
AGCACGGGTGATTGACCTT -> GCACGGGTGATTGACCTTC
AGCACTCCGGGCTTGCTCT -> GCACTCCGGGCTTGCTCTG
AGCACTTCCGAGACTACTT -> GCACTTCCGAGACTACTTC
AGCAGGGCTGGGCCTAAAA -> GCAGGGCTGGGCCTAAAAA
AGCATACGCCGTAAATCGA -> GCATACGCCGTAAATCGAG
AGCATAGACCAAGGCTGTC -> GCATAGACCAAGGCTGTCA
AGCATGTACAAACGGACCG -> GCATGTACAAACGGACCGT
AGCATGTACCTTGTCTGTG -> GCATGTACCTTGTCTGTGG
AGCATGTACGCTACGATAC -> GCATGTACGCTACGATACG
AGCATGTACTTGATAGCGG -> GCATGTACTTGATAGCGGT
AGCATTCTATACAAGTGAG -> GCATTCTATACAAGTGAGT
AGCCCAACATTATTTTAAC -> GCCCAACATTATTTTAACA
AGCCCATCGTAGCCTTACA -> GCCCATCGTAGCCTTACAA
AGCCCCATTACCAAGGGCG -> GCCCCATTACCAAGGGCGC
AGCCCGCAGCCCATCGTAG -> GCCCGCAGCCCATCGTAGC
AGCCCGGTCTCTAAACCAC -> GCCCGGTCTCTAAACCACG
AGCCGATTTCGAGCATGTA -> GCCGATTTCGAGCATGTAC
AGCCGCGGGCAACGAGATG -> GCCGCGGGCAACGAGATGA
AGCCGGTCAACCATTAATT -> GCCGGTCAACCATTAATTT
AGCCTGACACCGTCGTGCC -> GCCTGACACCGTCGTGCCC
AGCCTTACAAAAGACTGAT -> GCCTTACAAAAGACTGATA
AGCGCGCGGCTCTGAGGCA -> GCGCGCGGCTCTGAGGCAT
AGCGCTAACTTAATGCGCA -> GCGCTAACTTAATGCGCAA
AGCGGGAAAAGGCTCACTG -> GCGGGAAAAGGCTCACTGT
AGCGGTCCCACACTTACAC -> GCGGTCCCACACTTACACG
AGCGGTTGGGCGGTGTACC -> GCGGTTGGGCGGTGTACCA
AGCGTAATCTGGACGGATC -> GCGTAATCTGGACGGATCC
AGCGTTGATCGTACCGTCT -> GCGTTGATCGTACCGTCTT
AGCGTTGCGTAGGTAGTAG -> GCGTTGCGTAGGTAGTAGT
AGCTACTGAATAAGTCGCT -> GCTACTGAATAAGTCGCTA
AGCTAGCGTAATCTGGACG -> GCTAGCGTAATCTGGACGG
AGCTCCTCCGGAAACTAAG -> GCTCCTCCGGAAACTAAGG
AGCTCGGCTCCGATTTCGA -> GCTCGGCTCCGATTTCGAG
AGCTGAAAGTGCCGCCAAC -> GCTGAAAGTGCCGCCAACC
AGCTTCGCCACCAATCAAC -> GCTTCGCCACCAATCAACT
AGGAAGACGAAAGTAAACT -> GGAAGACGAAAGTAAACTA
AGGAATCAGACCCCAGAGA -> GGAATCAGACCCCAGAGAT
AGGACGGGCATATACAGCG -> GGACGGGCATATACAGCGC
AGGAGCCTGACACCGTCGT -> GGAGCCTGACACCGTCGTG
AGGAGTACAATACACGCCT -> GGAGTACAATACACGCCTA
AGGATACAGTCGACCTCTC -> GGATACAGTCGACCTCTCA
AGGATATGATTTGACTCCC -> GGATATGATTTGACTCCCC
AGGATTAGGCTGTTGAACT -> GGATTAGGCTGTTGAACTA
AGGCATTCAAGAGCCCGCA -> GGCATTCAAGAGCCCGCAG
AGGCATTTCTCACTCGCTG -> GGCATTTCTCACTCGCTGC
AGGCCCGACCTGACGTAGA -> GGCCCGACCTGACGTAGAA
AGGCCCTACGAGACTTCCT -> GGCCCTACGAGACTTCCTG
AGGCCGAGCACGGGTGATT -> GGCCGAGCACGGGTGATTG
AGGCCGCATTGTGTGTGAA -> GGCCGCATTGTGTGTGAAT
AGGCCTGTGGAGGCCCTAC -> GGCCTGTGGAGGCCCTACG
AGGCGGGTTTCGACACAAT -> GGCGGGTTTCGACACAATG
AGGCGTAATGACTTCAAAG -> GGCGTAATGACTTCAAAGA
AGGCGTCTAAGGCCCGACC -> GGCGTCTAAGGCCCGACCT
AGGCTCACTGTGCCATGGA -> GGCTCACTGTGCCATGGAT
AGGCTGTCAGCGTTGCGTA -> GGCTGTCAGCGTTGCGTAG
AGGCTGTTGAACTAGGGAG -> GGCTGTTGAACTAGGGAGG
AGGGAATGGTAAACAGCCC -> GGGAATGGTAAACAGCCCA
AGGGAGGCCGAGCACGGGT -> GGGAGGCCGAGCACGGGTG
AGGGAGGTGAGCTACTGAA -> GGGAGGTGAGCTACTGAAT
AGGGCGCTCGCAGGCCGCA -> GGGCGCTCGCAGGCCGCAT
AGGGCTGGGCCTAAAAATT -> GGGCTGGGCCTAAAAATTT
AGGGGGAAGGAGTACAATA -> GGGGGAAGGAGTACAATAC
AGGGTACTATGAAGACACC -> GGGTACTATGAAGACACCG
AGGGTATCCAAGAAGCGTT -> GGGTATCCAAGAAGCGTTG
AGGGTATTGAGGTGCTTTC -> GGGTATTGAGGTGCTTTCC
AGGGTGCAATTCTAGATTC -> GGGTGCAATTCTAGATTCC
AGGTAACCTAGGTGTGGGT -> GGTAACCTAGGTGTGGGTA
AGGTACAAGCATACGCCGT -> GGTACAAGCATACGCCGTA
AGGTAGTAGTTTTGCTACA -> GGTAGTAGTTTTGCTACAG
AGGTAGTGGCTAAAATAAA -> GGTAGTGGCTAAAATAAAT
AGGTCCGACACTATCTGAC -> GGTCCGACACTATCTGACA
AGGTGAGCTACTGAATAAG -> GGTGAGCTACTGAATAAGT
AGGTGCTGGCGCCATCCCT -> GGTGCTGGCGCCATCCCTA
AGGTGCTTTCCTTAATTGT -> GGTGCTTTCCTTAATTGTG
AGGTGGCCTTACATTCATC -> GGTGGCCTTACATTCATCC
AGGTGTCCCTTCCGACACA -> GGTGTCCCTTCCGACACAA
AGGTGTGGGTAAACTTAAG -> GGTGTGGGTAAACTTAAGG
AGGTTGATTTGAGGTGCTG -> GGTTGATTTGAGGTGCTGG
AGGTTTGCTGTCGAAACGA -> GGTTTGCTGTCGAAACGAA
AGTAAACTAGTCGCCGTTT -> GTAAACTAGTCGCCGTTTT
AGTACAATACACGCCTAGT -> GTACAATACACGCCTAGTT
AGTACCTACAGTTACCGAT -> GTACCTACAGTTACCGATC
AGTACGGGAACGCCGGGAG -> GTACGGGAACGCCGGGAGA
AGTACGGTGCAGCTAGCGT -> GTACGGTGCAGCTAGCGTA
AGTACTCTTACAACGTGGT -> GTACTCTTACAACGTGGTC
AGTAGTTTTGCTACAGGAT -> GTAGTTTTGCTACAGGATA
AGTATCGAAGTACGGGAAC -> GTATCGAAGTACGGGAACG
AGTCCATTTATTAGAGTAT -> GTCCATTTATTAGAGTATC
AGTCGACCTCTCAACGTTG -> GTCGACCTCTCAACGTTGC
AGTCGATACCTGCAGGGTA -> GTCGATACCTGCAGGGTAT
AGTCGCCGTTTTCTTGGCA -> GTCGCCGTTTTCTTGGCAC
AGTCGCTAGTACCTACAGT -> GTCGCTAGTACCTACAGTT
AGTCTACGTGCGGGACAGA -> GTCTACGTGCGGGACAGAT
AGTGAGGTGTCCCTTCCGA -> GTGAGGTGTCCCTTCCGAC
AGTGAGTGGGAAGTACGGT -> GTGAGTGGGAAGTACGGTG
AGTGCCGCCAACCACGTTG -> GTGCCGCCAACCACGTTGG
AGTGGCTAAAATAAATATA -> GTGGCTAAAATAAATATAT
AGTGGGAAGTACGGTGCAG -> GTGGGAAGTACGGTGCAGC
AGTGTAAAGCAATAAATGT -> GTGTAAAGCAATAAATGTA
AGTTACCGATCTGCCGGGC -> GTTACCGATCTGCCGGGCC
AGTTCTGGACGGCCTTGCA -> GTTCTGGACGGCCTTGCAG
AGTTTATCCGCCACGCCGG -> GTTTATCCGCCACGCCGGC
AGTTTTAGCCGCGGGCAAC -> GTTTTAGCCGCGGGCAACG
AGTTTTGCTACAGGATATG -> GTTTTGCTACAGGATATGA
ATAAAAGGTACAAGCATAC -> TAAAAGGTACAAGCATACG
ATAAATATATCCAAAGCGG -> TAAATATATCCAAAGCGGG
ATAAATGTACGGCGCGTCC -> TAAATGTACGGCGCGTCCG
ATAAGGGTATTGAGGTGCT -> TAAGGGTATTGAGGTGCTT
ATAAGTCGCTAGTACCTAC -> TAAGTCGCTAGTACCTACA
ATACAAGTGAGTGGGAAGT -> TACAAGTGAGTGGGAAGTA
ATACACGCCTAGTTCTGGA -> TACACGCCTAGTTCTGGAC
ATACACGTTTAAGGCGTAA -> TACACGTTTAAGGCGTAAT
ATACAGCGCTAACTTAATG -> TACAGCGCTAACTTAATGC
ATACAGTCGACCTCTCAAC -> TACAGTCGACCTCTCAACG
ATACCGATTTCGAGCATGT -> TACCGATTTCGAGCATGTA
ATACCTGCAGGGTATCCAA -> TACCTGCAGGGTATCCAAG
ATACGCCGTAAATCGAGCA -> TACGCCGTAAATCGAGCAC
ATACGGACGAGTTTTAGCC -> TACGGACGAGTTTTAGCCG
ATACGTGGGCGGTGTACCA -> TACGTGGGCGGTGTACCAT
ATACTAGCAGGGCTGGGCC -> TACTAGCAGGGCTGGGCCT
ATAGACCAAGGCTGTCAGC -> TAGACCAAGGCTGTCAGCG
ATAGCACGCAAAAGGGGGA -> TAGCACGCAAAAGGGGGAA
ATAGCCGGTCAACCATTAA -> TAGCCGGTCAACCATTAAT
ATAGCGGTTGGGCGGTGTA -> TAGCGGTTGGGCGGTGTAC
ATAGGAGCCTGACACCGTC -> TAGGAGCCTGACACCGTCG
ATAGTACTCTTACAACGTG -> TAGTACTCTTACAACGTGG
ATATACACGTTTAAGGCGT -> TATACACGTTTAAGGCGTA
ATATACAGCGCTAACTTAA -> TATACAGCGCTAACTTAAT
ATATAGCACGCAAAAGGGG -> TATAGCACGCAAAAGGGGG
ATATATCCAAAGCGGGAAA -> TATATCCAAAGCGGGAAAA
ATATCCAAAGCGGGAAAAG -> TATCCAAAGCGGGAAAAGG
ATATGATTTGACTCCCCTA -> TATGATTTGACTCCCCTAT
ATATGGCAATGAGAAGTGA -> TATGGCAATGAGAAGTGAG
ATATGGTTATATACACGTT -> TATGGTTATATACACGTTT
ATCAACCGCAGGTAACCTA -> TCAACCGCAGGTAACCTAG
ATCAACGAAGGCCTGTGGA -> TCAACGAAGGCCTGTGGAG
ATCAACTCTTCTCGGGCGA -> TCAACTCTTCTCGGGCGAT
ATCAACTGCTCGAACTAAA -> TCAACTGCTCGAACTAAAG
ATCAACTTCCTTGCGCTAC -> TCAACTTCCTTGCGCTACG
ATCAGACCCCAGAGATTAA -> TCAGACCCCAGAGATTAAT
ATCAGTCCATTTATTAGAG -> TCAGTCCATTTATTAGAGT
ATCCAAAGCGGGAAAAGGC -> TCCAAAGCGGGAAAAGGCT
ATCCAAGAAGCGTTGATCG -> TCCAAGAAGCGTTGATCGT
ATCCAGCCCCATTACCAAG -> TCCAGCCCCATTACCAAGG
ATCCCTAACTGTCGAGATG -> TCCCTAACTGTCGAGATGC
ATCCCTCAACCATAGGAGC -> TCCCTCAACCATAGGAGCC
ATCCGCCACGCCGGCCAAG -> TCCGCCACGCCGGCCAAGG
ATCCTGCCTAGTGTAAAGC -> TCCTGCCTAGTGTAAAGCA
ATCGAAGTACGGGAACGCC -> TCGAAGTACGGGAACGCCG
ATCGAGCACTCCGGGCTTG -> TCGAGCACTCCGGGCTTGC
ATCGGGTGCAATGTTCCTA -> TCGGGTGCAATGTTCCTAG
ATCGTACCGTCTTCGCCAT -> TCGTACCGTCTTCGCCATT
ATCGTAGCCTTACAAAAGA -> TCGTAGCCTTACAAAAGAC
ATCGTAGGTTGATTTGAGG -> TCGTAGGTTGATTTGAGGT
ATCGTGGTCCTTCCCACTC -> TCGTGGTCCTTCCCACTCG
ATCTATAGTACTCTTACAA -> TCTATAGTACTCTTACAAC
ATCTGACATATAGCACGCA -> TCTGACATATAGCACGCAA
ATCTGCCGGGCCCAGGGTG -> TCTGCCGGGCCCAGGGTGC
ATCTGGACGGATCCTGCCT -> TCTGGACGGATCCTGCCTA
ATCTGGCAGTCTACGTGCG -> TCTGGCAGTCTACGTGCGG
ATCTTAACGGGCTTGTGCA -> TCTTAACGGGCTTGTGCAT
ATGAAGACACCGTCTCAAC -> TGAAGACACCGTCTCAACT
ATGAAGATCCAGCCCCATT -> TGAAGATCCAGCCCCATTA
ATGACTGGAATGCATCTTA -> TGACTGGAATGCATCTTAA
ATGACTTCAAAGACATTGG -> TGACTTCAAAGACATTGGC
ATGAGAAGTGAGGTGTCCC -> TGAGAAGTGAGGTGTCCCT
ATGATACGGACGAGTTTTA -> TGATACGGACGAGTTTTAG
ATGATCGGGTGCAATGTTC -> TGATCGGGTGCAATGTTCC
ATGATTTGACTCCCCTATG -> TGATTTGACTCCCCTATGT
ATGCATCTTAACGGGCTTG -> TGCATCTTAACGGGCTTGT
ATGCGCAACGGTCCGAACC -> TGCGCAACGGTCCGAACCA
ATGCGCTGCACAACCAAGA -> TGCGCTGCACAACCAAGAC
ATGCGTAGTTTATCCGCCA -> TGCGTAGTTTATCCGCCAC
ATGCTCCAAGGAAGACGAA -> TGCTCCAAGGAAGACGAAA
ATGGATGATACGGACGAGT -> TGGATGATACGGACGAGTT
ATGGCAATGAGAAGTGAGG -> TGGCAATGAGAAGTGAGGT
ATGGCATCTGGCAGTCTAC -> TGGCATCTGGCAGTCTACG
ATGGCCGGCCGGGAACATT -> TGGCCGGCCGGGAACATTT
ATGGCTGTAGGATACAGTC -> TGGCTGTAGGATACAGTCG
ATGGTAAACAGCCCAACAT -> TGGTAAACAGCCCAACATT
ATGGTTATATACACGTTTA -> TGGTTATATACACGTTTAA
ATGTACAAACGGACCGTTG -> TGTACAAACGGACCGTTGG
ATGTACCTTGTCTGTGGTG -> TGTACCTTGTCTGTGGTGG
ATGTACGCTACGATACGTG -> TGTACGCTACGATACGTGG
ATGTACGGCGCGTCCGCGT -> TGTACGGCGCGTCCGCGTC
ATGTACTTGATAGCGGTTG -> TGTACTTGATAGCGGTTGG
ATGTATCTATAGTACTCTT -> TGTATCTATAGTACTCTTA
ATGTTAACCGAATTTTCAT -> TGTTAACCGAATTTTCATA
ATGTTCCTAGCCCGGTCTC -> TGTTCCTAGCCCGGTCTCT
ATTAATTACTGAAGGATTA -> TTAATTACTGAAGGATTAG
ATTAATTTACGCCGAGCTC -> TTAATTTACGCCGAGCTCC
ATTACCAAGGGCGCTCGCA -> TTACCAAGGGCGCTCGCAG
ATTACTGAAGGATTAGGCT -> TTACTGAAGGATTAGGCTG
ATTACTTTAGCTCGGCTCC -> TTACTTTAGCTCGGCTCCG
ATTAGAGTATCGAAGTACG -> TTAGAGTATCGAAGTACGG
ATTAGGCTGTTGAACTAGG -> TTAGGCTGTTGAACTAGGG
ATTATTGCCGACAGATCAG -> TTATTGCCGACAGATCAGT
ATTATTTTAACAATGATCG -> TTATTTTAACAATGATCGG
ATTCAAGAGCCCGCAGCCC -> TTCAAGAGCCCGCAGCCCA
ATTCATCCCTCAACCATAG -> TTCATCCCTCAACCATAGG
ATTCCAATGGCCGGCCGGG -> TTCCAATGGCCGGCCGGGA
ATTCCCAGGACGGGCATAT -> TTCCCAGGACGGGCATATA
ATTCGACGGGGTCGGGCGA -> TTCGACGGGGTCGGGCGAT
ATTCTAGATTCCCAGGACG -> TTCTAGATTCCCAGGACGG
ATTCTATACAAGTGAGTGG -> TTCTATACAAGTGAGTGGG
ATTGACCTTCGTTTAGCCT -> TTGACCTTCGTTTAGCCTA
ATTGAGGTGCTTTCCTTAA -> TTGAGGTGCTTTCCTTAAT
ATTGCCGACAGATCAGTCC -> TTGCCGACAGATCAGTCCA
ATTGCGTAAGTCGATACCT -> TTGCGTAAGTCGATACCTG
ATTGGCACAACTCAGGTAG -> TTGGCACAACTCAGGTAGT
ATTGTGTCCGGAAGCATAG -> TTGTGTCCGGAAGCATAGA
ATTGTGTGTGAATTCGACG -> TTGTGTGTGAATTCGACGG
ATTTACGCCGAGCTCCTCC -> TTTACGCCGAGCTCCTCCG
ATTTATTAGAGTATCGAAG -> TTTATTAGAGTATCGAAGT
ATTTCATACCGATTTCGAG -> TTTCATACCGATTTCGAGC
ATTTCGAGCATGTACAAAC -> TTTCGAGCATGTACAAACG
ATTTCGAGCATGTACCTTG -> TTTCGAGCATGTACCTTGT
ATTTCGAGCATGTACGCTA -> TTTCGAGCATGTACGCTAC
ATTTCGAGCATGTACTTGA -> TTTCGAGCATGTACTTGAT
ATTTCTCACTCGCTGCAGC -> TTTCTCACTCGCTGCAGCT
ATTTGACTCCCCTATGTAT -> TTTGACTCCCCTATGTATC
ATTTGAGGTGCTGGCGCCA -> TTTGAGGTGCTGGCGCCAT
ATTTTAACAATGATCGGGT -> TTTTAACAATGATCGGGTG
ATTTTCATATGGCAATGAG -> TTTTCATATGGCAATGAGA
ATTTTTGTCCTCCGACCTA -> TTTTTGTCCTCCGACCTAG
CAAAAGACTGATAGCCGGT -> AAAAGACTGATAGCCGGTC
CAAAAGGGGGAAGGAGTAC -> AAAAGGGGGAAGGAGTACA
CAAACGGACCGTTGGGCGG -> AAACGGACCGTTGGGCGGT
CAAAGACATTGGCACAACT -> AAAGACATTGGCACAACTC
CAAAGCGGGAAAAGGCTCA -> AAAGCGGGAAAAGGCTCAC
CAAAGGCGGGTTTCGACAC -> AAAGGCGGGTTTCGACACA
CAACATTATTTTAACAATG -> AACATTATTTTAACAATGA
CAACCAAGACCTATGCGTA -> AACCAAGACCTATGCGTAG
CAACCACGTTGGACCGGGT -> AACCACGTTGGACCGGGTA
CAACCATAGGAGCCTGACA -> AACCATAGGAGCCTGACAC
CAACCATTAATTTACGCCG -> AACCATTAATTTACGCCGA
CAACCGCAGGTAACCTAGG -> AACCGCAGGTAACCTAGGT
CAACGAAGGCCTGTGGAGG -> AACGAAGGCCTGTGGAGGC
CAACGAGATGAAGATCCAG -> AACGAGATGAAGATCCAGC
CAACGGCAATGACTGGAAT -> AACGGCAATGACTGGAATG
CAACGGTCCGAACCAGAAC -> AACGGTCCGAACCAGAACA
CAACGTGGTCAGACACCAT -> AACGTGGTCAGACACCATT
CAACGTTGCTTCCAGACAT -> AACGTTGCTTCCAGACATC
CAACTCAGGTAGTGGCTAA -> AACTCAGGTAGTGGCTAAA
CAACTCTTCTCGGGCGATT -> AACTCTTCTCGGGCGATTG
CAACTGCTCGAACTAAAGG -> AACTGCTCGAACTAAAGGA
CAACTTCCTTGCGCTACGC -> AACTTCCTTGCGCTACGCT
CAACTTGAGGTTTGCTGTC -> AACTTGAGGTTTGCTGTCG
CAAGAAGCGTTGATCGTAC -> AAGAAGCGTTGATCGTACC
CAAGACCTATGCGTAGTTT -> AAGACCTATGCGTAGTTTA
CAAGAGCCCGCAGCCCATC -> AAGAGCCCGCAGCCCATCG
CAAGCACTTCCGAGACTAC -> AAGCACTTCCGAGACTACT
CAAGCATACGCCGTAAATC -> AAGCATACGCCGTAAATCG
CAAGGAAGACGAAAGTAAA -> AAGGAAGACGAAAGTAAAC
CAAGGCTGTCAGCGTTGCG -> AAGGCTGTCAGCGTTGCGT
CAAGGGCGCTCGCAGGCCG -> AAGGGCGCTCGCAGGCCGC
CAAGGTGGCCTTACATTCA -> AAGGTGGCCTTACATTCAT
CAAGTGAGTGGGAAGTACG -> AAGTGAGTGGGAAGTACGG
CAATAAATGTACGGCGCGT -> AATAAATGTACGGCGCGTC
CAATACACGCCTAGTTCTG -> AATACACGCCTAGTTCTGG
CAATCAACTTCCTTGCGCT -> AATCAACTTCCTTGCGCTA
CAATGACTGGAATGCATCT -> AATGACTGGAATGCATCTT
CAATGAGAAGTGAGGTGTC -> AATGAGAAGTGAGGTGTCC
CAATGATCGGGTGCAATGT -> AATGATCGGGTGCAATGTT
CAATGGCCGGCCGGGAACA -> AATGGCCGGCCGGGAACAT
CAATGGCTGTAGGATACAG -> AATGGCTGTAGGATACAGT
CAATGTTCCTAGCCCGGTC -> AATGTTCCTAGCCCGGTCT
CAATTCTAGATTCCCAGGA -> AATTCTAGATTCCCAGGAC
CACAACCAAGACCTATGCG -> ACAACCAAGACCTATGCGT
CACAACGGCAATGACTGGA -> ACAACGGCAATGACTGGAA
CACAACTCAGGTAGTGGCT -> ACAACTCAGGTAGTGGCTA
CACAAGCACTTCCGAGACT -> ACAAGCACTTCCGAGACTA
CACAATGGCTGTAGGATAC -> ACAATGGCTGTAGGATACA
CACACTGATACTAGCAGGG -> ACACTGATACTAGCAGGGC
CACACTTACACGGTCGGCT -> ACACTTACACGGTCGGCTT
CACAGCGCGCGGCTCTGAG -> ACAGCGCGCGGCTCTGAGG
CACCAATCAACTTCCTTGC -> ACCAATCAACTTCCTTGCG
CACCATTACTTTAGCTCGG -> ACCATTACTTTAGCTCGGC
CACCCGCCCTTCGGATAAA -> ACCCGCCCTTCGGATAAAA
CACCCTGCAAAGGCGGGTT -> ACCCTGCAAAGGCGGGTTT
CACCGTCGTGCCCTGGTTA -> ACCGTCGTGCCCTGGTTAT
CACCGTCTCAACTTGAGGT -> ACCGTCTCAACTTGAGGTT
CACCTACCTACGTTGTCAG -> ACCTACCTACGTTGTCAGC
CACGCAAAAGGGGGAAGGA -> ACGCAAAAGGGGGAAGGAG
CACGCCGGCCAAGGTGGCC -> ACGCCGGCCAAGGTGGCCT
CACGCCTAGTTCTGGACGG -> ACGCCTAGTTCTGGACGGC
CACGCTGCTAAAAAACCTG -> ACGCTGCTAAAAAACCTGC
CACGGGTGATTGACCTTCG -> ACGGGTGATTGACCTTCGT
CACGGTCGGCTTCTCTGTC -> ACGGTCGGCTTCTCTGTCC
CACGTTGGACCGGGTAGCG -> ACGTTGGACCGGGTAGCGG
CACGTTTAAGGCGTAATGA -> ACGTTTAAGGCGTAATGAC
CACTATCTGACATATAGCA -> ACTATCTGACATATAGCAC
CACTCCGGGCTTGCTCTGC -> ACTCCGGGCTTGCTCTGCA
CACTCGCGCTAGATTCCAA -> ACTCGCGCTAGATTCCAAT
CACTCGCTGCAGCTGAAAG -> ACTCGCTGCAGCTGAAAGT
CACTGATACTAGCAGGGCT -> ACTGATACTAGCAGGGCTG
CACTGTGCCATGGATGATA -> ACTGTGCCATGGATGATAC
CACTTACACGGTCGGCTTC -> ACTTACACGGTCGGCTTCT
CACTTCATGGCATCTGGCA -> ACTTCATGGCATCTGGCAG
CACTTCCGAGACTACTTCA -> ACTTCCGAGACTACTTCAC
CAGAACAGCCGATTTCGAG -> AGAACAGCCGATTTCGAGC
CAGACACCATTACTTTAGC -> AGACACCATTACTTTAGCT
CAGACATCGTAGGTTGATT -> AGACATCGTAGGTTGATTT
CAGACCCCAGAGATTAATT -> AGACCCCAGAGATTAATTA
CAGAGATTAATTACTGAAG -> AGAGATTAATTACTGAAGG
CAGAGCTTCGCCACCAATC -> AGAGCTTCGCCACCAATCA
CAGATCAGTCCATTTATTA -> AGATCAGTCCATTTATTAG
CAGATCGTGGTCCTTCCCA -> AGATCGTGGTCCTTCCCAC
CAGCACCCGCCCTTCGGAT -> AGCACCCGCCCTTCGGATA
CAGCCCAACATTATTTTAA -> AGCCCAACATTATTTTAAC
CAGCCCATCGTAGCCTTAC -> AGCCCATCGTAGCCTTACA
CAGCCCCATTACCAAGGGC -> AGCCCCATTACCAAGGGCG
CAGCCGATTTCGAGCATGT -> AGCCGATTTCGAGCATGTA
CAGCGCGCGGCTCTGAGGC -> AGCGCGCGGCTCTGAGGCA
CAGCGCTAACTTAATGCGC -> AGCGCTAACTTAATGCGCA
CAGCGTTGCGTAGGTAGTA -> AGCGTTGCGTAGGTAGTAG
CAGCTAGCGTAATCTGGAC -> AGCTAGCGTAATCTGGACG
CAGCTGAAAGTGCCGCCAA -> AGCTGAAAGTGCCGCCAAC
CAGGACGGGCATATACAGC -> AGGACGGGCATATACAGCG
CAGGATATGATTTGACTCC -> AGGATATGATTTGACTCCC
CAGGCCGCATTGTGTGTGA -> AGGCCGCATTGTGTGTGAA
CAGGGCTGGGCCTAAAAAT -> AGGGCTGGGCCTAAAAATT
CAGGGTATCCAAGAAGCGT -> AGGGTATCCAAGAAGCGTT
CAGGGTGCAATTCTAGATT -> AGGGTGCAATTCTAGATTC
CAGGTAACCTAGGTGTGGG -> AGGTAACCTAGGTGTGGGT
CAGGTAGTGGCTAAAATAA -> AGGTAGTGGCTAAAATAAA
CAGTCCATTTATTAGAGTA -> AGTCCATTTATTAGAGTAT
CAGTCGACCTCTCAACGTT -> AGTCGACCTCTCAACGTTG
CAGTCTACGTGCGGGACAG -> AGTCTACGTGCGGGACAGA
CAGTTACCGATCTGCCGGG -> AGTTACCGATCTGCCGGGC
CATAAGGGTATTGAGGTGC -> ATAAGGGTATTGAGGTGCT
CATACCGATTTCGAGCATG -> ATACCGATTTCGAGCATGT
CATACGCCGTAAATCGAGC -> ATACGCCGTAAATCGAGCA
CATAGACCAAGGCTGTCAG -> ATAGACCAAGGCTGTCAGC
CATAGGAGCCTGACACCGT -> ATAGGAGCCTGACACCGTC
CATATACAGCGCTAACTTA -> ATATACAGCGCTAACTTAA
CATATAGCACGCAAAAGGG -> ATATAGCACGCAAAAGGGG
CATATGGCAATGAGAAGTG -> ATATGGCAATGAGAAGTGA
CATCAACCGCAGGTAACCT -> ATCAACCGCAGGTAACCTA
CATCAACGAAGGCCTGTGG -> ATCAACGAAGGCCTGTGGA
CATCAACTCTTCTCGGGCG -> ATCAACTCTTCTCGGGCGA
CATCAACTGCTCGAACTAA -> ATCAACTGCTCGAACTAAA
CATCCCTAACTGTCGAGAT -> ATCCCTAACTGTCGAGATG
CATCCCTCAACCATAGGAG -> ATCCCTCAACCATAGGAGC
CATCGTAGCCTTACAAAAG -> ATCGTAGCCTTACAAAAGA
CATCGTAGGTTGATTTGAG -> ATCGTAGGTTGATTTGAGG
CATCTGGCAGTCTACGTGC -> ATCTGGCAGTCTACGTGCG
CATCTTAACGGGCTTGTGC -> ATCTTAACGGGCTTGTGCA
CATGGATGATACGGACGAG -> ATGGATGATACGGACGAGT
CATGGCATCTGGCAGTCTA -> ATGGCATCTGGCAGTCTAC
CATGTACAAACGGACCGTT -> ATGTACAAACGGACCGTTG
CATGTACCTTGTCTGTGGT -> ATGTACCTTGTCTGTGGTG
CATGTACGCTACGATACGT -> ATGTACGCTACGATACGTG
CATGTACTTGATAGCGGTT -> ATGTACTTGATAGCGGTTG
CATTAATTTACGCCGAGCT -> ATTAATTTACGCCGAGCTC
CATTACCAAGGGCGCTCGC -> ATTACCAAGGGCGCTCGCA
CATTACTTTAGCTCGGCTC -> ATTACTTTAGCTCGGCTCC
CATTATTGCCGACAGATCA -> ATTATTGCCGACAGATCAG
CATTATTTTAACAATGATC -> ATTATTTTAACAATGATCG
CATTCAAGAGCCCGCAGCC -> ATTCAAGAGCCCGCAGCCC
CATTCATCCCTCAACCATA -> ATTCATCCCTCAACCATAG
CATTCTATACAAGTGAGTG -> ATTCTATACAAGTGAGTGG
CATTGGCACAACTCAGGTA -> ATTGGCACAACTCAGGTAG
CATTGTGTGTGAATTCGAC -> ATTGTGTGTGAATTCGACG
CATTTATTAGAGTATCGAA -> ATTTATTAGAGTATCGAAG
CATTTCATACCGATTTCGA -> ATTTCATACCGATTTCGAG
CATTTCTCACTCGCTGCAG -> ATTTCTCACTCGCTGCAGC
CCAAAGCGGGAAAAGGCTC -> CAAAGCGGGAAAAGGCTCA
CCAACATTATTTTAACAAT -> CAACATTATTTTAACAATG
CCAACCACGTTGGACCGGG -> CAACCACGTTGGACCGGGT
CCAAGAAGCGTTGATCGTA -> CAAGAAGCGTTGATCGTAC
CCAAGACCTATGCGTAGTT -> CAAGACCTATGCGTAGTTT
CCAAGGAAGACGAAAGTAA -> CAAGGAAGACGAAAGTAAA
CCAAGGCTGTCAGCGTTGC -> CAAGGCTGTCAGCGTTGCG
CCAAGGGCGCTCGCAGGCC -> CAAGGGCGCTCGCAGGCCG
CCAAGGTGGCCTTACATTC -> CAAGGTGGCCTTACATTCA
CCAATCAACTTCCTTGCGC -> CAATCAACTTCCTTGCGCT
CCAATGGCCGGCCGGGAAC -> CAATGGCCGGCCGGGAACA
CCACACTTACACGGTCGGC -> CACACTTACACGGTCGGCT
CCACCAATCAACTTCCTTG -> CACCAATCAACTTCCTTGC
CCACGCCGGCCAAGGTGGC -> CACGCCGGCCAAGGTGGCC
CCACGCTGCTAAAAAACCT -> CACGCTGCTAAAAAACCTG
CCACGTTGGACCGGGTAGC -> CACGTTGGACCGGGTAGCG
CCACTCGCGCTAGATTCCA -> CACTCGCGCTAGATTCCAA
CCACTTCATGGCATCTGGC -> CACTTCATGGCATCTGGCA
CCAGAACAGCCGATTTCGA -> CAGAACAGCCGATTTCGAG
CCAGACATCGTAGGTTGAT -> CAGACATCGTAGGTTGATT
CCAGAGATTAATTACTGAA -> CAGAGATTAATTACTGAAG
CCAGCCCCATTACCAAGGG -> CAGCCCCATTACCAAGGGC
CCAGGACGGGCATATACAG -> CAGGACGGGCATATACAGC
CCAGGGTGCAATTCTAGAT -> CAGGGTGCAATTCTAGATT
CCATAGGAGCCTGACACCG -> CATAGGAGCCTGACACCGT
CCATCAACCGCAGGTAACC -> CATCAACCGCAGGTAACCT
CCATCAACGAAGGCCTGTG -> CATCAACGAAGGCCTGTGG
CCATCAACTCTTCTCGGGC -> CATCAACTCTTCTCGGGCG
CCATCAACTGCTCGAACTA -> CATCAACTGCTCGAACTAA
CCATCCCTAACTGTCGAGA -> CATCCCTAACTGTCGAGAT
CCATCGTAGCCTTACAAAA -> CATCGTAGCCTTACAAAAG
CCATGGATGATACGGACGA -> CATGGATGATACGGACGAG
CCATTAATTTACGCCGAGC -> CATTAATTTACGCCGAGCT
CCATTACCAAGGGCGCTCG -> CATTACCAAGGGCGCTCGC
CCATTACTTTAGCTCGGCT -> CATTACTTTAGCTCGGCTC
CCATTATTGCCGACAGATC -> CATTATTGCCGACAGATCA
CCATTTATTAGAGTATCGA -> CATTTATTAGAGTATCGAA
CCCAACATTATTTTAACAA -> CCAACATTATTTTAACAAT
CCCACACTTACACGGTCGG -> CCACACTTACACGGTCGGC
CCCACTCGCGCTAGATTCC -> CCACTCGCGCTAGATTCCA
CCCAGAGATTAATTACTGA -> CCAGAGATTAATTACTGAA
CCCAGGACGGGCATATACA -> CCAGGACGGGCATATACAG
CCCAGGGTGCAATTCTAGA -> CCAGGGTGCAATTCTAGAT
CCCATCGTAGCCTTACAAA -> CCATCGTAGCCTTACAAAA
CCCATTACCAAGGGCGCTC -> CCATTACCAAGGGCGCTCG
CCCCAGAGATTAATTACTG -> CCCAGAGATTAATTACTGA
CCCCATTACCAAGGGCGCT -> CCCATTACCAAGGGCGCTC
CCCCCGATTTCGAGCATGT -> CCCCGATTTCGAGCATGTA
CCCCGATTTCGAGCATGTA -> CCCGATTTCGAGCATGTAC
CCCCTATGTATCTATAGTA -> CCCTATGTATCTATAGTAC
CCCGACCTGACGTAGAAGA -> CCGACCTGACGTAGAAGAA
CCCGATTTCGAGCATGTAC -> CCGATTTCGAGCATGTACC
CCCGCAGCCCATCGTAGCC -> CCGCAGCCCATCGTAGCCT
CCCGCCCTTCGGATAAAAG -> CCGCCCTTCGGATAAAAGG
CCCGGTCTCTAAACCACGC -> CCGGTCTCTAAACCACGCT
CCCTAACTGTCGAGATGCG -> CCTAACTGTCGAGATGCGC
CCCTACGAGACTTCCTGTG -> CCTACGAGACTTCCTGTGT
CCCTATGTATCTATAGTAC -> CCTATGTATCTATAGTACT
CCCTCAACCATAGGAGCCT -> CCTCAACCATAGGAGCCTG
CCCTGCAAAGGCGGGTTTC -> CCTGCAAAGGCGGGTTTCG
CCCTGGTTATGTTAACCGA -> CCTGGTTATGTTAACCGAA
CCCTTCCGACACAAGCACT -> CCTTCCGACACAAGCACTT
CCCTTCGGATAAAAGGTAC -> CCTTCGGATAAAAGGTACA
CCGAACCAGAACAGCCGAT -> CGAACCAGAACAGCCGATT
CCGAATTTTCATATGGCAA -> CGAATTTTCATATGGCAAT
CCGACACAAGCACTTCCGA -> CGACACAAGCACTTCCGAG
CCGACACTATCTGACATAT -> CGACACTATCTGACATATA
CCGACAGATCAGTCCATTT -> CGACAGATCAGTCCATTTA
CCGACCTAGAGGGAATGGT -> CGACCTAGAGGGAATGGTA
CCGACCTGACGTAGAAGAA -> CGACCTGACGTAGAAGAAG
CCGAGACTACTTCACAACG -> CGAGACTACTTCACAACGG
CCGAGCACGGGTGATTGAC -> CGAGCACGGGTGATTGACC
CCGAGCTCCTCCGGAAACT -> CGAGCTCCTCCGGAAACTA
CCGATCTGCCGGGCCCAGG -> CGATCTGCCGGGCCCAGGG
CCGATTTCGAGCATGTACA -> CGATTTCGAGCATGTACAA
CCGATTTCGAGCATGTACC -> CGATTTCGAGCATGTACCT
CCGATTTCGAGCATGTACG -> CGATTTCGAGCATGTACGC
CCGATTTCGAGCATGTACT -> CGATTTCGAGCATGTACTT
CCGCAGCCCATCGTAGCCT -> CGCAGCCCATCGTAGCCTT
CCGCAGGTAACCTAGGTGT -> CGCAGGTAACCTAGGTGTG
CCGCATTGTGTGTGAATTC -> CGCATTGTGTGTGAATTCG
CCGCCAACCACGTTGGACC -> CGCCAACCACGTTGGACCG
CCGCCACGCCGGCCAAGGT -> CGCCACGCCGGCCAAGGTG
CCGCCCTTCGGATAAAAGG -> CGCCCTTCGGATAAAAGGT
CCGCGGGCAACGAGATGAA -> CGCGGGCAACGAGATGAAG
CCGCGTCCTGGGTCGCGGA -> CGCGTCCTGGGTCGCGGAT
CCGGAAACTAAGGCGTCTA -> CGGAAACTAAGGCGTCTAA
CCGGAAGCATAGACCAAGG -> CGGAAGCATAGACCAAGGC
CCGGCCAAGGTGGCCTTAC -> CGGCCAAGGTGGCCTTACA
CCGGCCGGGAACATTTCAT -> CGGCCGGGAACATTTCATA
CCGGGAACATTTCATACCG -> CGGGAACATTTCATACCGA
CCGGGAGAGGTCCGACACT -> CGGGAGAGGTCCGACACTA
CCGGGCCCAGGGTGCAATT -> CGGGCCCAGGGTGCAATTC
CCGGGCTTGCTCTGCACCC -> CGGGCTTGCTCTGCACCCT
CCGGGTAGCGGTCCCACAC -> CGGGTAGCGGTCCCACACT
CCGGTCAACCATTAATTTA -> CGGTCAACCATTAATTTAC
CCGGTCTCTAAACCACGCT -> CGGTCTCTAAACCACGCTG
CCGTAAATCGAGCACTCCG -> CGTAAATCGAGCACTCCGG
CCGTCGTGCCCTGGTTATG -> CGTCGTGCCCTGGTTATGT
CCGTCTCAACTTGAGGTTT -> CGTCTCAACTTGAGGTTTG
CCGTCTTCGCCATTATTGC -> CGTCTTCGCCATTATTGCC
CCGTTGGGCGGTGTACCAT -> CGTTGGGCGGTGTACCATC
CCGTTTTCTTGGCACACTG -> CGTTTTCTTGGCACACTGA
CCTAAAAATTTTTGTCCTC -> CTAAAAATTTTTGTCCTCC
CCTAACTGTCGAGATGCGC -> CTAACTGTCGAGATGCGCT
CCTACAGTTACCGATCTGC -> CTACAGTTACCGATCTGCC
CCTACCTACGTTGTCAGCA -> CTACCTACGTTGTCAGCAC
CCTACGAGACTTCCTGTGT -> CTACGAGACTTCCTGTGTT
CCTACGTTGTCAGCACCCG -> CTACGTTGTCAGCACCCGC
CCTAGAGGGAATGGTAAAC -> CTAGAGGGAATGGTAAACA
CCTAGCCCGGTCTCTAAAC -> CTAGCCCGGTCTCTAAACC
CCTAGGTGTGGGTAAACTT -> CTAGGTGTGGGTAAACTTA
CCTAGTGTAAAGCAATAAA -> CTAGTGTAAAGCAATAAAT
CCTAGTTCTGGACGGCCTT -> CTAGTTCTGGACGGCCTTG
CCTATGCGTAGTTTATCCG -> CTATGCGTAGTTTATCCGC
CCTATGTATCTATAGTACT -> CTATGTATCTATAGTACTC
CCTCAACCATAGGAGCCTG -> CTCAACCATAGGAGCCTGA
CCTCCGACCTAGAGGGAAT -> CTCCGACCTAGAGGGAATG
CCTCCGGAAACTAAGGCGT -> CTCCGGAAACTAAGGCGTC
CCTCTCAACGTTGCTTCCA -> CTCTCAACGTTGCTTCCAG
CCTGACACCGTCGTGCCCT -> CTGACACCGTCGTGCCCTG
CCTGACGTAGAAGAAGCAT -> CTGACGTAGAAGAAGCATT
CCTGCAAAGGCGGGTTTCG -> CTGCAAAGGCGGGTTTCGA
CCTGCAGGGTATCCAAGAA -> CTGCAGGGTATCCAAGAAG
CCTGCCTAGTGTAAAGCAA -> CTGCCTAGTGTAAAGCAAT
CCTGCGGACACCTACCTAC -> CTGCGGACACCTACCTACG
CCTGGGTCGCGGATATGGT -> CTGGGTCGCGGATATGGTT
CCTGGTTATGTTAACCGAA -> CTGGTTATGTTAACCGAAT
CCTGTGGAGGCCCTACGAG -> CTGTGGAGGCCCTACGAGA
CCTGTGTTGCCCCCGATTT -> CTGTGTTGCCCCCGATTTC
CCTTAATTGTGTCCGGAAG -> CTTAATTGTGTCCGGAAGC
CCTTACAAAAGACTGATAG -> CTTACAAAAGACTGATAGC
CCTTACATTCATCCCTCAA -> CTTACATTCATCCCTCAAC
CCTTCCCACTCGCGCTAGA -> CTTCCCACTCGCGCTAGAT
CCTTCCGACACAAGCACTT -> CTTCCGACACAAGCACTTC
CCTTCGGATAAAAGGTACA -> CTTCGGATAAAAGGTACAA
CCTTGCAGAGCTTCGCCAC -> CTTGCAGAGCTTCGCCACC
CCTTGCGCTACGCTCACAG -> CTTGCGCTACGCTCACAGC
CCTTGTCTGTGGTGGGCGG -> CTTGTCTGTGGTGGGCGGT
CGAAACGAAGGCATTCAAG -> GAAACGAAGGCATTCAAGA
CGAAAGTAAACTAGTCGCC -> GAAAGTAAACTAGTCGCCG
CGAACCAGAACAGCCGATT -> GAACCAGAACAGCCGATTT
CGAACTAAAGGAATCAGAC -> GAACTAAAGGAATCAGACC
CGAAGGCATTCAAGAGCCC -> GAAGGCATTCAAGAGCCCG
CGAAGGCCTGTGGAGGCCC -> GAAGGCCTGTGGAGGCCCT
CGAAGTACGGGAACGCCGG -> GAAGTACGGGAACGCCGGG
CGAATTTTCATATGGCAAT -> GAATTTTCATATGGCAATG
CGACACAAGCACTTCCGAG -> GACACAAGCACTTCCGAGA
CGACACAATGGCTGTAGGA -> GACACAATGGCTGTAGGAT
CGACACTATCTGACATATA -> GACACTATCTGACATATAG
CGACAGATCAGTCCATTTA -> GACAGATCAGTCCATTTAT
CGACCTAGAGGGAATGGTA -> GACCTAGAGGGAATGGTAA
CGACCTCTCAACGTTGCTT -> GACCTCTCAACGTTGCTTC
CGACCTGACGTAGAAGAAG -> GACCTGACGTAGAAGAAGC
CGACGGGGTCGGGCGATGC -> GACGGGGTCGGGCGATGCT
CGAGACTACTTCACAACGG -> GAGACTACTTCACAACGGC
CGAGACTTCCTGTGTTGCC -> GAGACTTCCTGTGTTGCCC
CGAGATGAAGATCCAGCCC -> GAGATGAAGATCCAGCCCC
CGAGATGCGCTGCACAACC -> GAGATGCGCTGCACAACCA
CGAGCACGGGTGATTGACC -> GAGCACGGGTGATTGACCT
CGAGCACTCCGGGCTTGCT -> GAGCACTCCGGGCTTGCTC
CGAGCATGTACAAACGGAC -> GAGCATGTACAAACGGACC
CGAGCATGTACCTTGTCTG -> GAGCATGTACCTTGTCTGT
CGAGCATGTACGCTACGAT -> GAGCATGTACGCTACGATA
CGAGCATGTACTTGATAGC -> GAGCATGTACTTGATAGCG
CGAGCTCCTCCGGAAACTA -> GAGCTCCTCCGGAAACTAA
CGAGTTTTAGCCGCGGGCA -> GAGTTTTAGCCGCGGGCAA
CGATACCTGCAGGGTATCC -> GATACCTGCAGGGTATCCA
CGATACGTGGGCGGTGTAC -> GATACGTGGGCGGTGTACC
CGATCTGCCGGGCCCAGGG -> GATCTGCCGGGCCCAGGGT
CGATGCTCCAAGGAAGACG -> GATGCTCCAAGGAAGACGA
CGATTGCGTAAGTCGATAC -> GATTGCGTAAGTCGATACC
CGATTTCGAGCATGTACAA -> GATTTCGAGCATGTACAAA
CGATTTCGAGCATGTACCT -> GATTTCGAGCATGTACCTT
CGATTTCGAGCATGTACGC -> GATTTCGAGCATGTACGCT
CGATTTCGAGCATGTACTT -> GATTTCGAGCATGTACTTG
CGCAAAAGGGGGAAGGAGT -> GCAAAAGGGGGAAGGAGTA
CGCAACGGTCCGAACCAGA -> GCAACGGTCCGAACCAGAA
CGCAGCCCATCGTAGCCTT -> GCAGCCCATCGTAGCCTTA
CGCAGGCCGCATTGTGTGT -> GCAGGCCGCATTGTGTGTG
CGCAGGTAACCTAGGTGTG -> GCAGGTAACCTAGGTGTGG
CGCATTGTGTGTGAATTCG -> GCATTGTGTGTGAATTCGA
CGCCAACCACGTTGGACCG -> GCCAACCACGTTGGACCGG
CGCCACCAATCAACTTCCT -> GCCACCAATCAACTTCCTT
CGCCACGCCGGCCAAGGTG -> GCCACGCCGGCCAAGGTGG
CGCCATCCCTAACTGTCGA -> GCCATCCCTAACTGTCGAG
CGCCATTATTGCCGACAGA -> GCCATTATTGCCGACAGAT
CGCCCTTCGGATAAAAGGT -> GCCCTTCGGATAAAAGGTA
CGCCGAGCTCCTCCGGAAA -> GCCGAGCTCCTCCGGAAAC
CGCCGGCCAAGGTGGCCTT -> GCCGGCCAAGGTGGCCTTA
CGCCGGGAGAGGTCCGACA -> GCCGGGAGAGGTCCGACAC
CGCCGTAAATCGAGCACTC -> GCCGTAAATCGAGCACTCC
CGCCGTTTTCTTGGCACAC -> GCCGTTTTCTTGGCACACT
CGCCTAGTTCTGGACGGCC -> GCCTAGTTCTGGACGGCCT
CGCGCGGCTCTGAGGCATT -> GCGCGGCTCTGAGGCATTT
CGCGCTAGATTCCAATGGC -> GCGCTAGATTCCAATGGCC
CGCGGATATGGTTATATAC -> GCGGATATGGTTATATACA
CGCGGCTCTGAGGCATTTC -> GCGGCTCTGAGGCATTTCT
CGCGGGCAACGAGATGAAG -> GCGGGCAACGAGATGAAGA
CGCGTCCGCGTCCTGGGTC -> GCGTCCGCGTCCTGGGTCG
CGCGTCCTGGGTCGCGGAT -> GCGTCCTGGGTCGCGGATA
CGCTAACTTAATGCGCAAC -> GCTAACTTAATGCGCAACG
CGCTACGATACGTGGGCGG -> GCTACGATACGTGGGCGGT
CGCTACGCTCACAGCGCGC -> GCTACGCTCACAGCGCGCG
CGCTAGATTCCAATGGCCG -> GCTAGATTCCAATGGCCGG
CGCTAGTACCTACAGTTAC -> GCTAGTACCTACAGTTACC
CGCTCACAGCGCGCGGCTC -> GCTCACAGCGCGCGGCTCT
CGCTCGCAGGCCGCATTGT -> GCTCGCAGGCCGCATTGTG
CGCTGCACAACCAAGACCT -> GCTGCACAACCAAGACCTA
CGCTGCAGCTGAAAGTGCC -> GCTGCAGCTGAAAGTGCCG
CGCTGCTAAAAAACCTGCG -> GCTGCTAAAAAACCTGCGG
CGGAAACTAAGGCGTCTAA -> GGAAACTAAGGCGTCTAAG
CGGAAGCATAGACCAAGGC -> GGAAGCATAGACCAAGGCT
CGGACACCTACCTACGTTG -> GGACACCTACCTACGTTGT
CGGACCGTTGGGCGGTGTA -> GGACCGTTGGGCGGTGTAC
CGGACGAGTTTTAGCCGCG -> GGACGAGTTTTAGCCGCGG
CGGATAAAAGGTACAAGCA -> GGATAAAAGGTACAAGCAT
CGGATATGGTTATATACAC -> GGATATGGTTATATACACG
CGGATCCTGCCTAGTGTAA -> GGATCCTGCCTAGTGTAAA
CGGCAATGACTGGAATGCA -> GGCAATGACTGGAATGCAT
CGGCCAAGGTGGCCTTACA -> GGCCAAGGTGGCCTTACAT
CGGCCGGGAACATTTCATA -> GGCCGGGAACATTTCATAC
CGGCCTTGCAGAGCTTCGC -> GGCCTTGCAGAGCTTCGCC
CGGCGCGTCCGCGTCCTGG -> GGCGCGTCCGCGTCCTGGG
CGGCTCCGATTTCGAGCAT -> GGCTCCGATTTCGAGCATG
CGGCTCTGAGGCATTTCTC -> GGCTCTGAGGCATTTCTCA
CGGCTTCTCTGTCCACTTC -> GGCTTCTCTGTCCACTTCA
CGGGAAAAGGCTCACTGTG -> GGGAAAAGGCTCACTGTGC
CGGGAACATTTCATACCGA -> GGGAACATTTCATACCGAT
CGGGAACGCCGGGAGAGGT -> GGGAACGCCGGGAGAGGTC
CGGGACAGATCGTGGTCCT -> GGGACAGATCGTGGTCCTT
CGGGAGAGGTCCGACACTA -> GGGAGAGGTCCGACACTAT
CGGGCAACGAGATGAAGAT -> GGGCAACGAGATGAAGATC
CGGGCATATACAGCGCTAA -> GGGCATATACAGCGCTAAC
CGGGCCCAGGGTGCAATTC -> GGGCCCAGGGTGCAATTCT
CGGGCGATGCTCCAAGGAA -> GGGCGATGCTCCAAGGAAG
CGGGCGATTGCGTAAGTCG -> GGGCGATTGCGTAAGTCGA
CGGGCTTGCTCTGCACCCT -> GGGCTTGCTCTGCACCCTG
CGGGCTTGTGCATAAGGGT -> GGGCTTGTGCATAAGGGTA
CGGGGTCGGGCGATGCTCC -> GGGGTCGGGCGATGCTCCA
CGGGTAGCGGTCCCACACT -> GGGTAGCGGTCCCACACTT
CGGGTGATTGACCTTCGTT -> GGGTGATTGACCTTCGTTT
CGGGTGCAATGTTCCTAGC -> GGGTGCAATGTTCCTAGCC
CGGGTTTCGACACAATGGC -> GGGTTTCGACACAATGGCT
CGGTCAACCATTAATTTAC -> GGTCAACCATTAATTTACG
CGGTCCCACACTTACACGG -> GGTCCCACACTTACACGGT
CGGTCCGAACCAGAACAGC -> GGTCCGAACCAGAACAGCC
CGGTCGGCTTCTCTGTCCA -> GGTCGGCTTCTCTGTCCAC
CGGTCTCTAAACCACGCTG -> GGTCTCTAAACCACGCTGC
CGGTGCAGCTAGCGTAATC -> GGTGCAGCTAGCGTAATCT
CGGTGTACCATCAACCGCA -> GGTGTACCATCAACCGCAG
CGGTGTACCATCAACGAAG -> GGTGTACCATCAACGAAGG
CGGTGTACCATCAACTCTT -> GGTGTACCATCAACTCTTC
CGGTGTACCATCAACTGCT -> GGTGTACCATCAACTGCTC
CGGTTGGGCGGTGTACCAT -> GGTTGGGCGGTGTACCATC
CGTAAATCGAGCACTCCGG -> GTAAATCGAGCACTCCGGG
CGTAAGTCGATACCTGCAG -> GTAAGTCGATACCTGCAGG
CGTAATCTGGACGGATCCT -> GTAATCTGGACGGATCCTG
CGTAATGACTTCAAAGACA -> GTAATGACTTCAAAGACAT
CGTACCGTCTTCGCCATTA -> GTACCGTCTTCGCCATTAT
CGTAGAAGAAGCATTCTAT -> GTAGAAGAAGCATTCTATA
CGTAGCCTTACAAAAGACT -> GTAGCCTTACAAAAGACTG
CGTAGGTAGTAGTTTTGCT -> GTAGGTAGTAGTTTTGCTA
CGTAGGTTGATTTGAGGTG -> GTAGGTTGATTTGAGGTGC
CGTAGTTTATCCGCCACGC -> GTAGTTTATCCGCCACGCC
CGTCCGCGTCCTGGGTCGC -> GTCCGCGTCCTGGGTCGCG
CGTCCTGGGTCGCGGATAT -> GTCCTGGGTCGCGGATATG
CGTCGTGCCCTGGTTATGT -> GTCGTGCCCTGGTTATGTT
CGTCTAAGGCCCGACCTGA -> GTCTAAGGCCCGACCTGAC
CGTCTCAACTTGAGGTTTG -> GTCTCAACTTGAGGTTTGC
CGTCTTCGCCATTATTGCC -> GTCTTCGCCATTATTGCCG
CGTGCCCTGGTTATGTTAA -> GTGCCCTGGTTATGTTAAC
CGTGCGGGACAGATCGTGG -> GTGCGGGACAGATCGTGGT
CGTGGGCGGTGTACCATCA -> GTGGGCGGTGTACCATCAA
CGTGGTCAGACACCATTAC -> GTGGTCAGACACCATTACT
CGTGGTCCTTCCCACTCGC -> GTGGTCCTTCCCACTCGCG
CGTTGATCGTACCGTCTTC -> GTTGATCGTACCGTCTTCG
CGTTGCGTAGGTAGTAGTT -> GTTGCGTAGGTAGTAGTTT
CGTTGCTTCCAGACATCGT -> GTTGCTTCCAGACATCGTA
CGTTGGACCGGGTAGCGGT -> GTTGGACCGGGTAGCGGTC
CGTTGGGCGGTGTACCATC -> GTTGGGCGGTGTACCATCA
CGTTGTCAGCACCCGCCCT -> GTTGTCAGCACCCGCCCTT
CGTTTAAGGCGTAATGACT -> GTTTAAGGCGTAATGACTT
CGTTTTCTTGGCACACTGA -> GTTTTCTTGGCACACTGAT
CTAAAAAACCTGCGGACAC -> TAAAAAACCTGCGGACACC
CTAAAAATTTTTGTCCTCC -> TAAAAATTTTTGTCCTCCG
CTAAAATAAATATATCCAA -> TAAAATAAATATATCCAAA
CTAAACCACGCTGCTAAAA -> TAAACCACGCTGCTAAAAA
CTAAAGGAATCAGACCCCA -> TAAAGGAATCAGACCCCAG
CTAACTGTCGAGATGCGCT -> TAACTGTCGAGATGCGCTG
CTAACTTAATGCGCAACGG -> TAACTTAATGCGCAACGGT
CTAAGGCCCGACCTGACGT -> TAAGGCCCGACCTGACGTA
CTAAGGCGTCTAAGGCCCG -> TAAGGCGTCTAAGGCCCGA
CTACAGGATATGATTTGAC -> TACAGGATATGATTTGACT
CTACAGTTACCGATCTGCC -> TACAGTTACCGATCTGCCG
CTACCTACGTTGTCAGCAC -> TACCTACGTTGTCAGCACC
CTACGAGACTTCCTGTGTT -> TACGAGACTTCCTGTGTTG
CTACGATACGTGGGCGGTG -> TACGATACGTGGGCGGTGT
CTACGCTCACAGCGCGCGG -> TACGCTCACAGCGCGCGGC
CTACGTGCGGGACAGATCG -> TACGTGCGGGACAGATCGT
CTACGTTGTCAGCACCCGC -> TACGTTGTCAGCACCCGCC
CTACTGAATAAGTCGCTAG -> TACTGAATAAGTCGCTAGT
CTACTTCACAACGGCAATG -> TACTTCACAACGGCAATGA
CTAGAGGGAATGGTAAACA -> TAGAGGGAATGGTAAACAG
CTAGATTCCAATGGCCGGC -> TAGATTCCAATGGCCGGCC
CTAGATTCCCAGGACGGGC -> TAGATTCCCAGGACGGGCA
CTAGCAGGGCTGGGCCTAA -> TAGCAGGGCTGGGCCTAAA
CTAGCCCGGTCTCTAAACC -> TAGCCCGGTCTCTAAACCA
CTAGCGTAATCTGGACGGA -> TAGCGTAATCTGGACGGAT
CTAGGGAGGCCGAGCACGG -> TAGGGAGGCCGAGCACGGG
CTAGGTGTGGGTAAACTTA -> TAGGTGTGGGTAAACTTAA
CTAGTACCTACAGTTACCG -> TAGTACCTACAGTTACCGA
CTAGTCGCCGTTTTCTTGG -> TAGTCGCCGTTTTCTTGGC
CTAGTGTAAAGCAATAAAT -> TAGTGTAAAGCAATAAATG
CTAGTTCTGGACGGCCTTG -> TAGTTCTGGACGGCCTTGC
CTATACAAGTGAGTGGGAA -> TATACAAGTGAGTGGGAAG
CTATAGTACTCTTACAACG -> TATAGTACTCTTACAACGT
CTATCTGACATATAGCACG -> TATCTGACATATAGCACGC
CTATGAAGACACCGTCTCA -> TATGAAGACACCGTCTCAA
CTATGCGTAGTTTATCCGC -> TATGCGTAGTTTATCCGCC
CTATGTATCTATAGTACTC -> TATGTATCTATAGTACTCT
CTCAACCATAGGAGCCTGA -> TCAACCATAGGAGCCTGAC
CTCAACGTTGCTTCCAGAC -> TCAACGTTGCTTCCAGACA
CTCAACTTGAGGTTTGCTG -> TCAACTTGAGGTTTGCTGT
CTCACAGCGCGCGGCTCTG -> TCACAGCGCGCGGCTCTGA
CTCACTCGCTGCAGCTGAA -> TCACTCGCTGCAGCTGAAA
CTCACTGTGCCATGGATGA -> TCACTGTGCCATGGATGAT
CTCAGGTAGTGGCTAAAAT -> TCAGGTAGTGGCTAAAATA
CTCCAAGGAAGACGAAAGT -> TCCAAGGAAGACGAAAGTA
CTCCCCTATGTATCTATAG -> TCCCCTATGTATCTATAGT
CTCCGACCTAGAGGGAATG -> TCCGACCTAGAGGGAATGG
CTCCGATTTCGAGCATGTA -> TCCGATTTCGAGCATGTAC
CTCCGGAAACTAAGGCGTC -> TCCGGAAACTAAGGCGTCT
CTCCGGGCTTGCTCTGCAC -> TCCGGGCTTGCTCTGCACC
CTCCTCCGGAAACTAAGGC -> TCCTCCGGAAACTAAGGCG
CTCGAACTAAAGGAATCAG -> TCGAACTAAAGGAATCAGA
CTCGCAGGCCGCATTGTGT -> TCGCAGGCCGCATTGTGTG
CTCGCGCTAGATTCCAATG -> TCGCGCTAGATTCCAATGG
CTCGCTGCAGCTGAAAGTG -> TCGCTGCAGCTGAAAGTGC
CTCGGCTCCGATTTCGAGC -> TCGGCTCCGATTTCGAGCA
CTCGGGCGATTGCGTAAGT -> TCGGGCGATTGCGTAAGTC
CTCTAAACCACGCTGCTAA -> TCTAAACCACGCTGCTAAA
CTCTCAACGTTGCTTCCAG -> TCTCAACGTTGCTTCCAGA
CTCTGAGGCATTTCTCACT -> TCTGAGGCATTTCTCACTC
CTCTGCACCCTGCAAAGGC -> TCTGCACCCTGCAAAGGCG
CTCTGTCCACTTCATGGCA -> TCTGTCCACTTCATGGCAT
CTCTTACAACGTGGTCAGA -> TCTTACAACGTGGTCAGAC
CTCTTCTCGGGCGATTGCG -> TCTTCTCGGGCGATTGCGT
CTGAAAGTGCCGCCAACCA -> TGAAAGTGCCGCCAACCAC
CTGAAGGATTAGGCTGTTG -> TGAAGGATTAGGCTGTTGA
CTGAATAAGTCGCTAGTAC -> TGAATAAGTCGCTAGTACC
CTGACACCGTCGTGCCCTG -> TGACACCGTCGTGCCCTGG
CTGACATATAGCACGCAAA -> TGACATATAGCACGCAAAA
CTGACGTAGAAGAAGCATT -> TGACGTAGAAGAAGCATTC
CTGAGGCATTTCTCACTCG -> TGAGGCATTTCTCACTCGC
CTGATACTAGCAGGGCTGG -> TGATACTAGCAGGGCTGGG
CTGATAGCCGGTCAACCAT -> TGATAGCCGGTCAACCATT
CTGCAAAGGCGGGTTTCGA -> TGCAAAGGCGGGTTTCGAC
CTGCACAACCAAGACCTAT -> TGCACAACCAAGACCTATG
CTGCACCCTGCAAAGGCGG -> TGCACCCTGCAAAGGCGGG
CTGCAGCTGAAAGTGCCGC -> TGCAGCTGAAAGTGCCGCC
CTGCAGGGTATCCAAGAAG -> TGCAGGGTATCCAAGAAGC
CTGCCGGGCCCAGGGTGCA -> TGCCGGGCCCAGGGTGCAA
CTGCCTAGTGTAAAGCAAT -> TGCCTAGTGTAAAGCAATA
CTGCGGACACCTACCTACG -> TGCGGACACCTACCTACGT
CTGCTAAAAAACCTGCGGA -> TGCTAAAAAACCTGCGGAC
CTGCTCGAACTAAAGGAAT -> TGCTCGAACTAAAGGAATC
CTGGAATGCATCTTAACGG -> TGGAATGCATCTTAACGGG
CTGGACGGATCCTGCCTAG -> TGGACGGATCCTGCCTAGT
CTGGACGGCCTTGCAGAGC -> TGGACGGCCTTGCAGAGCT
CTGGCAGTCTACGTGCGGG -> TGGCAGTCTACGTGCGGGA
CTGGCGCCATCCCTAACTG -> TGGCGCCATCCCTAACTGT
CTGGGCCTAAAAATTTTTG -> TGGGCCTAAAAATTTTTGT
CTGGGTCGCGGATATGGTT -> TGGGTCGCGGATATGGTTA
CTGGTTATGTTAACCGAAT -> TGGTTATGTTAACCGAATT
CTGTAGGATACAGTCGACC -> TGTAGGATACAGTCGACCT
CTGTCAGCGTTGCGTAGGT -> TGTCAGCGTTGCGTAGGTA
CTGTCCACTTCATGGCATC -> TGTCCACTTCATGGCATCT
CTGTCGAAACGAAGGCATT -> TGTCGAAACGAAGGCATTC
CTGTCGAGATGCGCTGCAC -> TGTCGAGATGCGCTGCACA
CTGTGCCATGGATGATACG -> TGTGCCATGGATGATACGG
CTGTGGAGGCCCTACGAGA -> TGTGGAGGCCCTACGAGAC
CTGTGGTGGGCGGTGTACC -> TGTGGTGGGCGGTGTACCA
CTGTGTTGCCCCCGATTTC -> TGTGTTGCCCCCGATTTCG
CTGTTGAACTAGGGAGGCC -> TGTTGAACTAGGGAGGCCG
CTTAACGGGCTTGTGCATA -> TTAACGGGCTTGTGCATAA
CTTAAGGGAGGTGAGCTAC -> TTAAGGGAGGTGAGCTACT
CTTAATGCGCAACGGTCCG -> TTAATGCGCAACGGTCCGA
CTTAATTGTGTCCGGAAGC -> TTAATTGTGTCCGGAAGCA
CTTACAAAAGACTGATAGC -> TTACAAAAGACTGATAGCC
CTTACAACGTGGTCAGACA -> TTACAACGTGGTCAGACAC
CTTACACGGTCGGCTTCTC -> TTACACGGTCGGCTTCTCT
CTTACATTCATCCCTCAAC -> TTACATTCATCCCTCAACC
CTTCAAAGACATTGGCACA -> TTCAAAGACATTGGCACAA
CTTCACAACGGCAATGACT -> TTCACAACGGCAATGACTG
CTTCATGGCATCTGGCAGT -> TTCATGGCATCTGGCAGTC
CTTCCAGACATCGTAGGTT -> TTCCAGACATCGTAGGTTG
CTTCCCACTCGCGCTAGAT -> TTCCCACTCGCGCTAGATT
CTTCCGACACAAGCACTTC -> TTCCGACACAAGCACTTCC
CTTCCGAGACTACTTCACA -> TTCCGAGACTACTTCACAA
CTTCCTGTGTTGCCCCCGA -> TTCCTGTGTTGCCCCCGAT
CTTCCTTGCGCTACGCTCA -> TTCCTTGCGCTACGCTCAC
CTTCGCCACCAATCAACTT -> TTCGCCACCAATCAACTTC
CTTCGCCATTATTGCCGAC -> TTCGCCATTATTGCCGACA
CTTCGGATAAAAGGTACAA -> TTCGGATAAAAGGTACAAG
CTTCTCGGGCGATTGCGTA -> TTCTCGGGCGATTGCGTAA
CTTCTCTGTCCACTTCATG -> TTCTCTGTCCACTTCATGG
CTTGAGGTTTGCTGTCGAA -> TTGAGGTTTGCTGTCGAAA
CTTGATAGCGGTTGGGCGG -> TTGATAGCGGTTGGGCGGT
CTTGCAGAGCTTCGCCACC -> TTGCAGAGCTTCGCCACCA
CTTGCGCTACGCTCACAGC -> TTGCGCTACGCTCACAGCG
CTTGCTCTGCACCCTGCAA -> TTGCTCTGCACCCTGCAAA
CTTGGCACACTGATACTAG -> TTGGCACACTGATACTAGC
CTTGTCTGTGGTGGGCGGT -> TTGTCTGTGGTGGGCGGTG
CTTGTGCATAAGGGTATTG -> TTGTGCATAAGGGTATTGA
CTTTAGCTCGGCTCCGATT -> TTTAGCTCGGCTCCGATTT
CTTTCCTTAATTGTGTCCG -> TTTCCTTAATTGTGTCCGG
GAAAAGGCTCACTGTGCCA -> AAAAGGCTCACTGTGCCAT
GAAACGAAGGCATTCAAGA -> AAACGAAGGCATTCAAGAG
GAAACTAAGGCGTCTAAGG -> AAACTAAGGCGTCTAAGGC
GAAAGTAAACTAGTCGCCG -> AAAGTAAACTAGTCGCCGT
GAAAGTGCCGCCAACCACG -> AAAGTGCCGCCAACCACGT
GAACAGCCGATTTCGAGCA -> AACAGCCGATTTCGAGCAT
GAACATTTCATACCGATTT -> AACATTTCATACCGATTTC
GAACCAGAACAGCCGATTT -> AACCAGAACAGCCGATTTC
GAACGCCGGGAGAGGTCCG -> AACGCCGGGAGAGGTCCGA
GAACTAAAGGAATCAGACC -> AACTAAAGGAATCAGACCC
GAACTAGGGAGGCCGAGCA -> AACTAGGGAGGCCGAGCAC
GAAGAAGCATTCTATACAA -> AAGAAGCATTCTATACAAG
GAAGACACCGTCTCAACTT -> AAGACACCGTCTCAACTTG
GAAGACGAAAGTAAACTAG -> AAGACGAAAGTAAACTAGT
GAAGATCCAGCCCCATTAC -> AAGATCCAGCCCCATTACC
GAAGCATAGACCAAGGCTG -> AAGCATAGACCAAGGCTGT
GAAGCATTCTATACAAGTG -> AAGCATTCTATACAAGTGA
GAAGCGTTGATCGTACCGT -> AAGCGTTGATCGTACCGTC
GAAGGAGTACAATACACGC -> AAGGAGTACAATACACGCC
GAAGGATTAGGCTGTTGAA -> AAGGATTAGGCTGTTGAAC
GAAGGCATTCAAGAGCCCG -> AAGGCATTCAAGAGCCCGC
GAAGGCCTGTGGAGGCCCT -> AAGGCCTGTGGAGGCCCTA
GAAGTACGGGAACGCCGGG -> AAGTACGGGAACGCCGGGA
GAAGTACGGTGCAGCTAGC -> AAGTACGGTGCAGCTAGCG
GAAGTGAGGTGTCCCTTCC -> AAGTGAGGTGTCCCTTCCG
GAATAAGTCGCTAGTACCT -> AATAAGTCGCTAGTACCTA
GAATCAGACCCCAGAGATT -> AATCAGACCCCAGAGATTA
GAATGCATCTTAACGGGCT -> AATGCATCTTAACGGGCTT
GAATGGTAAACAGCCCAAC -> AATGGTAAACAGCCCAACA
GAATTCGACGGGGTCGGGC -> AATTCGACGGGGTCGGGCG
GAATTTTCATATGGCAATG -> AATTTTCATATGGCAATGA
GACACAAGCACTTCCGAGA -> ACACAAGCACTTCCGAGAC
GACACAATGGCTGTAGGAT -> ACACAATGGCTGTAGGATA
GACACCATTACTTTAGCTC -> ACACCATTACTTTAGCTCG
GACACCGTCGTGCCCTGGT -> ACACCGTCGTGCCCTGGTT
GACACCGTCTCAACTTGAG -> ACACCGTCTCAACTTGAGG
GACACCTACCTACGTTGTC -> ACACCTACCTACGTTGTCA
GACACTATCTGACATATAG -> ACACTATCTGACATATAGC
GACAGATCAGTCCATTTAT -> ACAGATCAGTCCATTTATT
GACAGATCGTGGTCCTTCC -> ACAGATCGTGGTCCTTCCC
GACATATAGCACGCAAAAG -> ACATATAGCACGCAAAAGG
GACATCGTAGGTTGATTTG -> ACATCGTAGGTTGATTTGA
GACATTGGCACAACTCAGG -> ACATTGGCACAACTCAGGT
GACCAAGGCTGTCAGCGTT -> ACCAAGGCTGTCAGCGTTG
GACCCCAGAGATTAATTAC -> ACCCCAGAGATTAATTACT
GACCGGGTAGCGGTCCCAC -> ACCGGGTAGCGGTCCCACA
GACCGTTGGGCGGTGTACC -> ACCGTTGGGCGGTGTACCA
GACCTAGAGGGAATGGTAA -> ACCTAGAGGGAATGGTAAA
GACCTATGCGTAGTTTATC -> ACCTATGCGTAGTTTATCC
GACCTCTCAACGTTGCTTC -> ACCTCTCAACGTTGCTTCC
GACCTGACGTAGAAGAAGC -> ACCTGACGTAGAAGAAGCA
GACGAAAGTAAACTAGTCG -> ACGAAAGTAAACTAGTCGC
GACGAGTTTTAGCCGCGGG -> ACGAGTTTTAGCCGCGGGC
GACGGATCCTGCCTAGTGT -> ACGGATCCTGCCTAGTGTA
GACGGCCTTGCAGAGCTTC -> ACGGCCTTGCAGAGCTTCG
GACGGGCATATACAGCGCT -> ACGGGCATATACAGCGCTA
GACGGGGTCGGGCGATGCT -> ACGGGGTCGGGCGATGCTC
GACGTAGAAGAAGCATTCT -> ACGTAGAAGAAGCATTCTA
GACTACTTCACAACGGCAA -> ACTACTTCACAACGGCAAT
GACTCCCCTATGTATCTAT -> ACTCCCCTATGTATCTATA
GACTGATAGCCGGTCAACC -> ACTGATAGCCGGTCAACCA
GACTGGAATGCATCTTAAC -> ACTGGAATGCATCTTAACG
GACTTCAAAGACATTGGCA -> ACTTCAAAGACATTGGCAC
GACTTCCTGTGTTGCCCCC -> ACTTCCTGTGTTGCCCCCG
GAGAAGTGAGGTGTCCCTT -> AGAAGTGAGGTGTCCCTTC
GAGACTACTTCACAACGGC -> AGACTACTTCACAACGGCA
GAGACTTCCTGTGTTGCCC -> AGACTTCCTGTGTTGCCCC
GAGAGGTCCGACACTATCT -> AGAGGTCCGACACTATCTG
GAGATGAAGATCCAGCCCC -> AGATGAAGATCCAGCCCCA
GAGATGCGCTGCACAACCA -> AGATGCGCTGCACAACCAA
GAGATTAATTACTGAAGGA -> AGATTAATTACTGAAGGAT
GAGCACGGGTGATTGACCT -> AGCACGGGTGATTGACCTT
GAGCACTCCGGGCTTGCTC -> AGCACTCCGGGCTTGCTCT
GAGCATGTACAAACGGACC -> AGCATGTACAAACGGACCG
GAGCATGTACCTTGTCTGT -> AGCATGTACCTTGTCTGTG
GAGCATGTACGCTACGATA -> AGCATGTACGCTACGATAC
GAGCATGTACTTGATAGCG -> AGCATGTACTTGATAGCGG
GAGCCCGCAGCCCATCGTA -> AGCCCGCAGCCCATCGTAG
GAGCCTGACACCGTCGTGC -> AGCCTGACACCGTCGTGCC
GAGCTACTGAATAAGTCGC -> AGCTACTGAATAAGTCGCT
GAGCTCCTCCGGAAACTAA -> AGCTCCTCCGGAAACTAAG
GAGCTTCGCCACCAATCAA -> AGCTTCGCCACCAATCAAC
GAGGCATTTCTCACTCGCT -> AGGCATTTCTCACTCGCTG
GAGGCCCTACGAGACTTCC -> AGGCCCTACGAGACTTCCT
GAGGCCGAGCACGGGTGAT -> AGGCCGAGCACGGGTGATT
GAGGGAATGGTAAACAGCC -> AGGGAATGGTAAACAGCCC
GAGGTCCGACACTATCTGA -> AGGTCCGACACTATCTGAC
GAGGTGAGCTACTGAATAA -> AGGTGAGCTACTGAATAAG
GAGGTGCTGGCGCCATCCC -> AGGTGCTGGCGCCATCCCT
GAGGTGCTTTCCTTAATTG -> AGGTGCTTTCCTTAATTGT
GAGGTGTCCCTTCCGACAC -> AGGTGTCCCTTCCGACACA
GAGGTTTGCTGTCGAAACG -> AGGTTTGCTGTCGAAACGA
GAGTACAATACACGCCTAG -> AGTACAATACACGCCTAGT
GAGTATCGAAGTACGGGAA -> AGTATCGAAGTACGGGAAC
GAGTGGGAAGTACGGTGCA -> AGTGGGAAGTACGGTGCAG
GAGTTTTAGCCGCGGGCAA -> AGTTTTAGCCGCGGGCAAC
GATAAAAGGTACAAGCATA -> ATAAAAGGTACAAGCATAC
GATACAGTCGACCTCTCAA -> ATACAGTCGACCTCTCAAC
GATACCTGCAGGGTATCCA -> ATACCTGCAGGGTATCCAA
GATACGGACGAGTTTTAGC -> ATACGGACGAGTTTTAGCC
GATACGTGGGCGGTGTACC -> ATACGTGGGCGGTGTACCA
GATACTAGCAGGGCTGGGC -> ATACTAGCAGGGCTGGGCC
GATAGCCGGTCAACCATTA -> ATAGCCGGTCAACCATTAA
GATAGCGGTTGGGCGGTGT -> ATAGCGGTTGGGCGGTGTA
GATATGATTTGACTCCCCT -> ATATGATTTGACTCCCCTA
GATATGGTTATATACACGT -> ATATGGTTATATACACGTT
GATCAGTCCATTTATTAGA -> ATCAGTCCATTTATTAGAG
GATCCAGCCCCATTACCAA -> ATCCAGCCCCATTACCAAG
GATCCTGCCTAGTGTAAAG -> ATCCTGCCTAGTGTAAAGC
GATCGGGTGCAATGTTCCT -> ATCGGGTGCAATGTTCCTA
GATCGTACCGTCTTCGCCA -> ATCGTACCGTCTTCGCCAT
GATCGTGGTCCTTCCCACT -> ATCGTGGTCCTTCCCACTC
GATCTGCCGGGCCCAGGGT -> ATCTGCCGGGCCCAGGGTG
GATGAAGATCCAGCCCCAT -> ATGAAGATCCAGCCCCATT
GATGATACGGACGAGTTTT -> ATGATACGGACGAGTTTTA
GATGCGCTGCACAACCAAG -> ATGCGCTGCACAACCAAGA
GATGCTCCAAGGAAGACGA -> ATGCTCCAAGGAAGACGAA
GATTAATTACTGAAGGATT -> ATTAATTACTGAAGGATTA
GATTAGGCTGTTGAACTAG -> ATTAGGCTGTTGAACTAGG
GATTCCAATGGCCGGCCGG -> ATTCCAATGGCCGGCCGGG
GATTCCCAGGACGGGCATA -> ATTCCCAGGACGGGCATAT
GATTGACCTTCGTTTAGCC -> ATTGACCTTCGTTTAGCCT
GATTGCGTAAGTCGATACC -> ATTGCGTAAGTCGATACCT
GATTTCGAGCATGTACAAA -> ATTTCGAGCATGTACAAAC
GATTTCGAGCATGTACCTT -> ATTTCGAGCATGTACCTTG
GATTTCGAGCATGTACGCT -> ATTTCGAGCATGTACGCTA
GATTTCGAGCATGTACTTG -> ATTTCGAGCATGTACTTGA
GATTTGACTCCCCTATGTA -> ATTTGACTCCCCTATGTAT
GATTTGAGGTGCTGGCGCC -> ATTTGAGGTGCTGGCGCCA
GCAAAAGGGGGAAGGAGTA -> CAAAAGGGGGAAGGAGTAC
GCAAAGGCGGGTTTCGACA -> CAAAGGCGGGTTTCGACAC
GCAACGAGATGAAGATCCA -> CAACGAGATGAAGATCCAG
GCAACGGTCCGAACCAGAA -> CAACGGTCCGAACCAGAAC
GCAATAAATGTACGGCGCG -> CAATAAATGTACGGCGCGT
GCAATGACTGGAATGCATC -> CAATGACTGGAATGCATCT
GCAATGAGAAGTGAGGTGT -> CAATGAGAAGTGAGGTGTC
GCAATGTTCCTAGCCCGGT -> CAATGTTCCTAGCCCGGTC
GCAATTCTAGATTCCCAGG -> CAATTCTAGATTCCCAGGA
GCACAACCAAGACCTATGC -> CACAACCAAGACCTATGCG
GCACAACTCAGGTAGTGGC -> CACAACTCAGGTAGTGGCT
GCACACTGATACTAGCAGG -> CACACTGATACTAGCAGGG
GCACCCGCCCTTCGGATAA -> CACCCGCCCTTCGGATAAA
GCACCCTGCAAAGGCGGGT -> CACCCTGCAAAGGCGGGTT
GCACGCAAAAGGGGGAAGG -> CACGCAAAAGGGGGAAGGA
GCACGGGTGATTGACCTTC -> CACGGGTGATTGACCTTCG
GCACTCCGGGCTTGCTCTG -> CACTCCGGGCTTGCTCTGC
GCACTTCCGAGACTACTTC -> CACTTCCGAGACTACTTCA
GCAGAGCTTCGCCACCAAT -> CAGAGCTTCGCCACCAATC
GCAGCCCATCGTAGCCTTA -> CAGCCCATCGTAGCCTTAC
GCAGCTAGCGTAATCTGGA -> CAGCTAGCGTAATCTGGAC
GCAGCTGAAAGTGCCGCCA -> CAGCTGAAAGTGCCGCCAA
GCAGGCCGCATTGTGTGTG -> CAGGCCGCATTGTGTGTGA
GCAGGGCTGGGCCTAAAAA -> CAGGGCTGGGCCTAAAAAT
GCAGGGTATCCAAGAAGCG -> CAGGGTATCCAAGAAGCGT
GCAGGTAACCTAGGTGTGG -> CAGGTAACCTAGGTGTGGG
GCAGTCTACGTGCGGGACA -> CAGTCTACGTGCGGGACAG
GCATAAGGGTATTGAGGTG -> CATAAGGGTATTGAGGTGC
GCATACGCCGTAAATCGAG -> CATACGCCGTAAATCGAGC
GCATAGACCAAGGCTGTCA -> CATAGACCAAGGCTGTCAG
GCATATACAGCGCTAACTT -> CATATACAGCGCTAACTTA
GCATCTGGCAGTCTACGTG -> CATCTGGCAGTCTACGTGC
GCATCTTAACGGGCTTGTG -> CATCTTAACGGGCTTGTGC
GCATGTACAAACGGACCGT -> CATGTACAAACGGACCGTT
GCATGTACCTTGTCTGTGG -> CATGTACCTTGTCTGTGGT
GCATGTACGCTACGATACG -> CATGTACGCTACGATACGT
GCATGTACTTGATAGCGGT -> CATGTACTTGATAGCGGTT
GCATTCAAGAGCCCGCAGC -> CATTCAAGAGCCCGCAGCC
GCATTCTATACAAGTGAGT -> CATTCTATACAAGTGAGTG
GCATTGTGTGTGAATTCGA -> CATTGTGTGTGAATTCGAC
GCATTTCTCACTCGCTGCA -> CATTTCTCACTCGCTGCAG
GCCAACCACGTTGGACCGG -> CCAACCACGTTGGACCGGG
GCCAAGGTGGCCTTACATT -> CCAAGGTGGCCTTACATTC
GCCACCAATCAACTTCCTT -> CCACCAATCAACTTCCTTG
GCCACGCCGGCCAAGGTGG -> CCACGCCGGCCAAGGTGGC
GCCATCCCTAACTGTCGAG -> CCATCCCTAACTGTCGAGA
GCCATGGATGATACGGACG -> CCATGGATGATACGGACGA
GCCATTATTGCCGACAGAT -> CCATTATTGCCGACAGATC
GCCCAACATTATTTTAACA -> CCCAACATTATTTTAACAA
GCCCAGGGTGCAATTCTAG -> CCCAGGGTGCAATTCTAGA
GCCCATCGTAGCCTTACAA -> CCCATCGTAGCCTTACAAA
GCCCCATTACCAAGGGCGC -> CCCCATTACCAAGGGCGCT
GCCCCCGATTTCGAGCATG -> CCCCCGATTTCGAGCATGT
GCCCGACCTGACGTAGAAG -> CCCGACCTGACGTAGAAGA
GCCCGCAGCCCATCGTAGC -> CCCGCAGCCCATCGTAGCC
GCCCGGTCTCTAAACCACG -> CCCGGTCTCTAAACCACGC
GCCCTACGAGACTTCCTGT -> CCCTACGAGACTTCCTGTG
GCCCTGGTTATGTTAACCG -> CCCTGGTTATGTTAACCGA
GCCCTTCGGATAAAAGGTA -> CCCTTCGGATAAAAGGTAC
GCCGACAGATCAGTCCATT -> CCGACAGATCAGTCCATTT
GCCGAGCACGGGTGATTGA -> CCGAGCACGGGTGATTGAC
GCCGAGCTCCTCCGGAAAC -> CCGAGCTCCTCCGGAAACT
GCCGATTTCGAGCATGTAC -> CCGATTTCGAGCATGTACG
GCCGCATTGTGTGTGAATT -> CCGCATTGTGTGTGAATTC
GCCGCCAACCACGTTGGAC -> CCGCCAACCACGTTGGACC
GCCGCGGGCAACGAGATGA -> CCGCGGGCAACGAGATGAA
GCCGGCCAAGGTGGCCTTA -> CCGGCCAAGGTGGCCTTAC
GCCGGCCGGGAACATTTCA -> CCGGCCGGGAACATTTCAT
GCCGGGAACATTTCATACC -> CCGGGAACATTTCATACCG
GCCGGGAGAGGTCCGACAC -> CCGGGAGAGGTCCGACACT
GCCGGGCCCAGGGTGCAAT -> CCGGGCCCAGGGTGCAATT
GCCGGTCAACCATTAATTT -> CCGGTCAACCATTAATTTA
GCCGTAAATCGAGCACTCC -> CCGTAAATCGAGCACTCCG
GCCGTTTTCTTGGCACACT -> CCGTTTTCTTGGCACACTG
GCCTAAAAATTTTTGTCCT -> CCTAAAAATTTTTGTCCTC
GCCTAGTGTAAAGCAATAA -> CCTAGTGTAAAGCAATAAA
GCCTAGTTCTGGACGGCCT -> CCTAGTTCTGGACGGCCTT
GCCTGACACCGTCGTGCCC -> CCTGACACCGTCGTGCCCT
GCCTGTGGAGGCCCTACGA -> CCTGTGGAGGCCCTACGAG
GCCTTACAAAAGACTGATA -> CCTTACAAAAGACTGATAG
GCCTTACATTCATCCCTCA -> CCTTACATTCATCCCTCAA
GCCTTGCAGAGCTTCGCCA -> CCTTGCAGAGCTTCGCCAC
GCGATGCTCCAAGGAAGAC -> CGATGCTCCAAGGAAGACG
GCGATTGCGTAAGTCGATA -> CGATTGCGTAAGTCGATAC
GCGCAACGGTCCGAACCAG -> CGCAACGGTCCGAACCAGA
GCGCCATCCCTAACTGTCG -> CGCCATCCCTAACTGTCGA
GCGCGCGGCTCTGAGGCAT -> CGCGCGGCTCTGAGGCATT
GCGCGGCTCTGAGGCATTT -> CGCGGCTCTGAGGCATTTC
GCGCGTCCGCGTCCTGGGT -> CGCGTCCGCGTCCTGGGTC
GCGCTAACTTAATGCGCAA -> CGCTAACTTAATGCGCAAC
GCGCTACGCTCACAGCGCG -> CGCTACGCTCACAGCGCGC
GCGCTAGATTCCAATGGCC -> CGCTAGATTCCAATGGCCG
GCGCTCGCAGGCCGCATTG -> CGCTCGCAGGCCGCATTGT
GCGCTGCACAACCAAGACC -> CGCTGCACAACCAAGACCT
GCGGACACCTACCTACGTT -> CGGACACCTACCTACGTTG
GCGGATATGGTTATATACA -> CGGATATGGTTATATACAC
GCGGCTCTGAGGCATTTCT -> CGGCTCTGAGGCATTTCTC
GCGGGAAAAGGCTCACTGT -> CGGGAAAAGGCTCACTGTG
GCGGGACAGATCGTGGTCC -> CGGGACAGATCGTGGTCCT
GCGGGCAACGAGATGAAGA -> CGGGCAACGAGATGAAGAT
GCGGGTTTCGACACAATGG -> CGGGTTTCGACACAATGGC
GCGGTCCCACACTTACACG -> CGGTCCCACACTTACACGG
GCGGTGTACCATCAACCGC -> CGGTGTACCATCAACCGCA
GCGGTGTACCATCAACGAA -> CGGTGTACCATCAACGAAG
GCGGTGTACCATCAACTCT -> CGGTGTACCATCAACTCTT
GCGGTGTACCATCAACTGC -> CGGTGTACCATCAACTGCT
GCGGTTGGGCGGTGTACCA -> CGGTTGGGCGGTGTACCAT
GCGTAAGTCGATACCTGCA -> CGTAAGTCGATACCTGCAG
GCGTAATCTGGACGGATCC -> CGTAATCTGGACGGATCCT
GCGTAATGACTTCAAAGAC -> CGTAATGACTTCAAAGACA
GCGTAGGTAGTAGTTTTGC -> CGTAGGTAGTAGTTTTGCT
GCGTAGTTTATCCGCCACG -> CGTAGTTTATCCGCCACGC
GCGTCCGCGTCCTGGGTCG -> CGTCCGCGTCCTGGGTCGC
GCGTCCTGGGTCGCGGATA -> CGTCCTGGGTCGCGGATAT
GCGTCTAAGGCCCGACCTG -> CGTCTAAGGCCCGACCTGA
GCGTTGATCGTACCGTCTT -> CGTTGATCGTACCGTCTTC
GCGTTGCGTAGGTAGTAGT -> CGTTGCGTAGGTAGTAGTT
GCTAAAAAACCTGCGGACA -> CTAAAAAACCTGCGGACAC
GCTAAAATAAATATATCCA -> CTAAAATAAATATATCCAA
GCTAACTTAATGCGCAACG -> CTAACTTAATGCGCAACGG
GCTACAGGATATGATTTGA -> CTACAGGATATGATTTGAC
GCTACGATACGTGGGCGGT -> CTACGATACGTGGGCGGTG
GCTACGCTCACAGCGCGCG -> CTACGCTCACAGCGCGCGG
GCTACTGAATAAGTCGCTA -> CTACTGAATAAGTCGCTAG
GCTAGATTCCAATGGCCGG -> CTAGATTCCAATGGCCGGC
GCTAGCGTAATCTGGACGG -> CTAGCGTAATCTGGACGGA
GCTAGTACCTACAGTTACC -> CTAGTACCTACAGTTACCG
GCTCACAGCGCGCGGCTCT -> CTCACAGCGCGCGGCTCTG
GCTCACTGTGCCATGGATG -> CTCACTGTGCCATGGATGA
GCTCCAAGGAAGACGAAAG -> CTCCAAGGAAGACGAAAGT
GCTCCGATTTCGAGCATGT -> CTCCGATTTCGAGCATGTA
GCTCCTCCGGAAACTAAGG -> CTCCTCCGGAAACTAAGGC
GCTCGAACTAAAGGAATCA -> CTCGAACTAAAGGAATCAG
GCTCGCAGGCCGCATTGTG -> CTCGCAGGCCGCATTGTGT
GCTCGGCTCCGATTTCGAG -> CTCGGCTCCGATTTCGAGC
GCTCTGAGGCATTTCTCAC -> CTCTGAGGCATTTCTCACT
GCTCTGCACCCTGCAAAGG -> CTCTGCACCCTGCAAAGGC
GCTGAAAGTGCCGCCAACC -> CTGAAAGTGCCGCCAACCA
GCTGCACAACCAAGACCTA -> CTGCACAACCAAGACCTAT
GCTGCAGCTGAAAGTGCCG -> CTGCAGCTGAAAGTGCCGC
GCTGCTAAAAAACCTGCGG -> CTGCTAAAAAACCTGCGGA
GCTGGCGCCATCCCTAACT -> CTGGCGCCATCCCTAACTG
GCTGGGCCTAAAAATTTTT -> CTGGGCCTAAAAATTTTTG
GCTGTAGGATACAGTCGAC -> CTGTAGGATACAGTCGACC
GCTGTCAGCGTTGCGTAGG -> CTGTCAGCGTTGCGTAGGT
GCTGTCGAAACGAAGGCAT -> CTGTCGAAACGAAGGCATT
GCTGTTGAACTAGGGAGGC -> CTGTTGAACTAGGGAGGCC
GCTTCCAGACATCGTAGGT -> CTTCCAGACATCGTAGGTT
GCTTCGCCACCAATCAACT -> CTTCGCCACCAATCAACTT
GCTTCTCTGTCCACTTCAT -> CTTCTCTGTCCACTTCATG
GCTTGCTCTGCACCCTGCA -> CTTGCTCTGCACCCTGCAA
GCTTGTGCATAAGGGTATT -> CTTGTGCATAAGGGTATTG
GCTTTCCTTAATTGTGTCC -> CTTTCCTTAATTGTGTCCG
GGAAAAGGCTCACTGTGCC -> GAAAAGGCTCACTGTGCCA
GGAAACTAAGGCGTCTAAG -> GAAACTAAGGCGTCTAAGG
GGAACATTTCATACCGATT -> GAACATTTCATACCGATTT
GGAACGCCGGGAGAGGTCC -> GAACGCCGGGAGAGGTCCG
GGAAGACGAAAGTAAACTA -> GAAGACGAAAGTAAACTAG
GGAAGCATAGACCAAGGCT -> GAAGCATAGACCAAGGCTG
GGAAGGAGTACAATACACG -> GAAGGAGTACAATACACGC
GGAAGTACGGTGCAGCTAG -> GAAGTACGGTGCAGCTAGC
GGAATCAGACCCCAGAGAT -> GAATCAGACCCCAGAGATT
GGAATGCATCTTAACGGGC -> GAATGCATCTTAACGGGCT
GGAATGGTAAACAGCCCAA -> GAATGGTAAACAGCCCAAC
GGACACCTACCTACGTTGT -> GACACCTACCTACGTTGTC
GGACAGATCGTGGTCCTTC -> GACAGATCGTGGTCCTTCC
GGACCGGGTAGCGGTCCCA -> GACCGGGTAGCGGTCCCAC
GGACCGTTGGGCGGTGTAC -> GACCGTTGGGCGGTGTACC
GGACGAGTTTTAGCCGCGG -> GACGAGTTTTAGCCGCGGG
GGACGGATCCTGCCTAGTG -> GACGGATCCTGCCTAGTGT
GGACGGCCTTGCAGAGCTT -> GACGGCCTTGCAGAGCTTC
GGACGGGCATATACAGCGC -> GACGGGCATATACAGCGCT
GGAGAGGTCCGACACTATC -> GAGAGGTCCGACACTATCT
GGAGCCTGACACCGTCGTG -> GAGCCTGACACCGTCGTGC
GGAGGCCCTACGAGACTTC -> GAGGCCCTACGAGACTTCC
GGAGGCCGAGCACGGGTGA -> GAGGCCGAGCACGGGTGAT
GGAGGTGAGCTACTGAATA -> GAGGTGAGCTACTGAATAA
GGAGTACAATACACGCCTA -> GAGTACAATACACGCCTAG
GGATAAAAGGTACAAGCAT -> GATAAAAGGTACAAGCATA
GGATACAGTCGACCTCTCA -> GATACAGTCGACCTCTCAA
GGATATGATTTGACTCCCC -> GATATGATTTGACTCCCCT
GGATATGGTTATATACACG -> GATATGGTTATATACACGT
GGATCCTGCCTAGTGTAAA -> GATCCTGCCTAGTGTAAAG
GGATGATACGGACGAGTTT -> GATGATACGGACGAGTTTT
GGATTAGGCTGTTGAACTA -> GATTAGGCTGTTGAACTAG
GGCAACGAGATGAAGATCC -> GCAACGAGATGAAGATCCA
GGCAATGACTGGAATGCAT -> GCAATGACTGGAATGCATC
GGCAATGAGAAGTGAGGTG -> GCAATGAGAAGTGAGGTGT
GGCACAACTCAGGTAGTGG -> GCACAACTCAGGTAGTGGC
GGCACACTGATACTAGCAG -> GCACACTGATACTAGCAGG
GGCAGTCTACGTGCGGGAC -> GCAGTCTACGTGCGGGACA
GGCATATACAGCGCTAACT -> GCATATACAGCGCTAACTT
GGCATCTGGCAGTCTACGT -> GCATCTGGCAGTCTACGTG
GGCATTCAAGAGCCCGCAG -> GCATTCAAGAGCCCGCAGC
GGCATTTCTCACTCGCTGC -> GCATTTCTCACTCGCTGCA
GGCCAAGGTGGCCTTACAT -> GCCAAGGTGGCCTTACATT
GGCCCAGGGTGCAATTCTA -> GCCCAGGGTGCAATTCTAG
GGCCCGACCTGACGTAGAA -> GCCCGACCTGACGTAGAAG
GGCCCTACGAGACTTCCTG -> GCCCTACGAGACTTCCTGT
GGCCGAGCACGGGTGATTG -> GCCGAGCACGGGTGATTGA
GGCCGCATTGTGTGTGAAT -> GCCGCATTGTGTGTGAATT
GGCCGGCCGGGAACATTTC -> GCCGGCCGGGAACATTTCA
GGCCGGGAACATTTCATAC -> GCCGGGAACATTTCATACC
GGCCTAAAAATTTTTGTCC -> GCCTAAAAATTTTTGTCCT
GGCCTGTGGAGGCCCTACG -> GCCTGTGGAGGCCCTACGA
GGCCTTACATTCATCCCTC -> GCCTTACATTCATCCCTCA
GGCCTTGCAGAGCTTCGCC -> GCCTTGCAGAGCTTCGCCA
GGCGATGCTCCAAGGAAGA -> GCGATGCTCCAAGGAAGAC
GGCGATTGCGTAAGTCGAT -> GCGATTGCGTAAGTCGATA
GGCGCCATCCCTAACTGTC -> GCGCCATCCCTAACTGTCG
GGCGCGTCCGCGTCCTGGG -> GCGCGTCCGCGTCCTGGGT
GGCGCTCGCAGGCCGCATT -> GCGCTCGCAGGCCGCATTG
GGCGGGTTTCGACACAATG -> GCGGGTTTCGACACAATGG
GGCGGTGTACCATCAACCG -> GCGGTGTACCATCAACCGC
GGCGGTGTACCATCAACGA -> GCGGTGTACCATCAACGAA
GGCGGTGTACCATCAACTC -> GCGGTGTACCATCAACTCT
GGCGGTGTACCATCAACTG -> GCGGTGTACCATCAACTGC
GGCGTAATGACTTCAAAGA -> GCGTAATGACTTCAAAGAC
GGCGTCTAAGGCCCGACCT -> GCGTCTAAGGCCCGACCTG
GGCTAAAATAAATATATCC -> GCTAAAATAAATATATCCA
GGCTCACTGTGCCATGGAT -> GCTCACTGTGCCATGGATG
GGCTCCGATTTCGAGCATG -> GCTCCGATTTCGAGCATGT
GGCTCTGAGGCATTTCTCA -> GCTCTGAGGCATTTCTCAC
GGCTGGGCCTAAAAATTTT -> GCTGGGCCTAAAAATTTTT
GGCTGTAGGATACAGTCGA -> GCTGTAGGATACAGTCGAC
GGCTGTCAGCGTTGCGTAG -> GCTGTCAGCGTTGCGTAGG
GGCTGTTGAACTAGGGAGG -> GCTGTTGAACTAGGGAGGC
GGCTTCTCTGTCCACTTCA -> GCTTCTCTGTCCACTTCAT
GGCTTGCTCTGCACCCTGC -> GCTTGCTCTGCACCCTGCA
GGCTTGTGCATAAGGGTAT -> GCTTGTGCATAAGGGTATT
GGGAAAAGGCTCACTGTGC -> GGAAAAGGCTCACTGTGCC
GGGAACATTTCATACCGAT -> GGAACATTTCATACCGATT
GGGAACGCCGGGAGAGGTC -> GGAACGCCGGGAGAGGTCC
GGGAAGGAGTACAATACAC -> GGAAGGAGTACAATACACG
GGGAAGTACGGTGCAGCTA -> GGAAGTACGGTGCAGCTAG
GGGAATGGTAAACAGCCCA -> GGAATGGTAAACAGCCCAA
GGGACAGATCGTGGTCCTT -> GGACAGATCGTGGTCCTTC
GGGAGAGGTCCGACACTAT -> GGAGAGGTCCGACACTATC
GGGAGGCCGAGCACGGGTG -> GGAGGCCGAGCACGGGTGA
GGGAGGTGAGCTACTGAAT -> GGAGGTGAGCTACTGAATA
GGGCAACGAGATGAAGATC -> GGCAACGAGATGAAGATCC
GGGCATATACAGCGCTAAC -> GGCATATACAGCGCTAACT
GGGCCCAGGGTGCAATTCT -> GGCCCAGGGTGCAATTCTA
GGGCCTAAAAATTTTTGTC -> GGCCTAAAAATTTTTGTCC
GGGCGATGCTCCAAGGAAG -> GGCGATGCTCCAAGGAAGA
GGGCGATTGCGTAAGTCGA -> GGCGATTGCGTAAGTCGAT
GGGCGCTCGCAGGCCGCAT -> GGCGCTCGCAGGCCGCATT
GGGCGGTGTACCATCAACC -> GGCGGTGTACCATCAACCG
GGGCGGTGTACCATCAACG -> GGCGGTGTACCATCAACGA
GGGCGGTGTACCATCAACT -> GGCGGTGTACCATCAACTC,GGCGGTGTACCATCAACTG
GGGCTGGGCCTAAAAATTT -> GGCTGGGCCTAAAAATTTT
GGGCTTGCTCTGCACCCTG -> GGCTTGCTCTGCACCCTGC
GGGCTTGTGCATAAGGGTA -> GGCTTGTGCATAAGGGTAT
GGGGAAGGAGTACAATACA -> GGGAAGGAGTACAATACAC
GGGGGAAGGAGTACAATAC -> GGGGAAGGAGTACAATACA
GGGGTCGGGCGATGCTCCA -> GGGTCGGGCGATGCTCCAA
GGGTAAACTTAAGGGAGGT -> GGTAAACTTAAGGGAGGTG
GGGTACTATGAAGACACCG -> GGTACTATGAAGACACCGT
GGGTAGCGGTCCCACACTT -> GGTAGCGGTCCCACACTTA
GGGTATCCAAGAAGCGTTG -> GGTATCCAAGAAGCGTTGA
GGGTATTGAGGTGCTTTCC -> GGTATTGAGGTGCTTTCCT
GGGTCGCGGATATGGTTAT -> GGTCGCGGATATGGTTATA
GGGTCGGGCGATGCTCCAA -> GGTCGGGCGATGCTCCAAG
GGGTGATTGACCTTCGTTT -> GGTGATTGACCTTCGTTTA
GGGTGCAATGTTCCTAGCC -> GGTGCAATGTTCCTAGCCC
GGGTGCAATTCTAGATTCC -> GGTGCAATTCTAGATTCCC
GGGTTTCGACACAATGGCT -> GGTTTCGACACAATGGCTG
GGTAAACAGCCCAACATTA -> GTAAACAGCCCAACATTAT
GGTAAACTTAAGGGAGGTG -> GTAAACTTAAGGGAGGTGA
GGTAACCTAGGTGTGGGTA -> GTAACCTAGGTGTGGGTAA
GGTACAAGCATACGCCGTA -> GTACAAGCATACGCCGTAA
GGTACTATGAAGACACCGT -> GTACTATGAAGACACCGTC
GGTAGCGGTCCCACACTTA -> GTAGCGGTCCCACACTTAC
GGTAGTAGTTTTGCTACAG -> GTAGTAGTTTTGCTACAGG
GGTAGTGGCTAAAATAAAT -> GTAGTGGCTAAAATAAATA
GGTATCCAAGAAGCGTTGA -> GTATCCAAGAAGCGTTGAT
GGTATTGAGGTGCTTTCCT -> GTATTGAGGTGCTTTCCTT
GGTCAACCATTAATTTACG -> GTCAACCATTAATTTACGC
GGTCAGACACCATTACTTT -> GTCAGACACCATTACTTTA
GGTCCCACACTTACACGGT -> GTCCCACACTTACACGGTC
GGTCCGAACCAGAACAGCC -> GTCCGAACCAGAACAGCCG
GGTCCGACACTATCTGACA -> GTCCGACACTATCTGACAT
GGTCCTTCCCACTCGCGCT -> GTCCTTCCCACTCGCGCTA
GGTCGCGGATATGGTTATA -> GTCGCGGATATGGTTATAT
GGTCGGCTTCTCTGTCCAC -> GTCGGCTTCTCTGTCCACT
GGTCGGGCGATGCTCCAAG -> GTCGGGCGATGCTCCAAGG
GGTCTCTAAACCACGCTGC -> GTCTCTAAACCACGCTGCT
GGTGAGCTACTGAATAAGT -> GTGAGCTACTGAATAAGTC
GGTGATTGACCTTCGTTTA -> GTGATTGACCTTCGTTTAG
GGTGCAATGTTCCTAGCCC -> GTGCAATGTTCCTAGCCCG
GGTGCAATTCTAGATTCCC -> GTGCAATTCTAGATTCCCA
GGTGCAGCTAGCGTAATCT -> GTGCAGCTAGCGTAATCTG
GGTGCTGGCGCCATCCCTA -> GTGCTGGCGCCATCCCTAA
GGTGCTTTCCTTAATTGTG -> GTGCTTTCCTTAATTGTGT
GGTGGCCTTACATTCATCC -> GTGGCCTTACATTCATCCC
GGTGGGCGGTGTACCATCA -> GTGGGCGGTGTACCATCAA
GGTGTACCATCAACCGCAG -> GTGTACCATCAACCGCAGG
GGTGTACCATCAACGAAGG -> GTGTACCATCAACGAAGGC
GGTGTACCATCAACTCTTC -> GTGTACCATCAACTCTTCT
GGTGTACCATCAACTGCTC -> GTGTACCATCAACTGCTCG
GGTGTCCCTTCCGACACAA -> GTGTCCCTTCCGACACAAG
GGTGTGGGTAAACTTAAGG -> GTGTGGGTAAACTTAAGGG
GGTTATATACACGTTTAAG -> GTTATATACACGTTTAAGG
GGTTATGTTAACCGAATTT -> GTTATGTTAACCGAATTTT
GGTTGATTTGAGGTGCTGG -> GTTGATTTGAGGTGCTGGC
GGTTGGGCGGTGTACCATC -> GTTGGGCGGTGTACCATCA
GGTTTCGACACAATGGCTG -> GTTTCGACACAATGGCTGT
GGTTTGCTGTCGAAACGAA -> GTTTGCTGTCGAAACGAAG
GTAAACAGCCCAACATTAT -> TAAACAGCCCAACATTATT
GTAAACTAGTCGCCGTTTT -> TAAACTAGTCGCCGTTTTC
GTAAACTTAAGGGAGGTGA -> TAAACTTAAGGGAGGTGAG
GTAAAGCAATAAATGTACG -> TAAAGCAATAAATGTACGG
GTAAATCGAGCACTCCGGG -> TAAATCGAGCACTCCGGGC
GTAACCTAGGTGTGGGTAA -> TAACCTAGGTGTGGGTAAA
GTAAGTCGATACCTGCAGG -> TAAGTCGATACCTGCAGGG
GTAATCTGGACGGATCCTG -> TAATCTGGACGGATCCTGC
GTAATGACTTCAAAGACAT -> TAATGACTTCAAAGACATT
GTACAAACGGACCGTTGGG -> TACAAACGGACCGTTGGGC
GTACAAGCATACGCCGTAA -> TACAAGCATACGCCGTAAA
GTACAATACACGCCTAGTT -> TACAATACACGCCTAGTTC
GTACCATCAACCGCAGGTA -> TACCATCAACCGCAGGTAA
GTACCATCAACGAAGGCCT -> TACCATCAACGAAGGCCTG
GTACCATCAACTCTTCTCG -> TACCATCAACTCTTCTCGG
GTACCATCAACTGCTCGAA -> TACCATCAACTGCTCGAAC
GTACCGTCTTCGCCATTAT -> TACCGTCTTCGCCATTATT
GTACCTACAGTTACCGATC -> TACCTACAGTTACCGATCT
GTACCTTGTCTGTGGTGGG -> TACCTTGTCTGTGGTGGGC
GTACGCTACGATACGTGGG -> TACGCTACGATACGTGGGC
GTACGGCGCGTCCGCGTCC -> TACGGCGCGTCCGCGTCCT
GTACGGGAACGCCGGGAGA -> TACGGGAACGCCGGGAGAG
GTACGGTGCAGCTAGCGTA -> TACGGTGCAGCTAGCGTAA
GTACTATGAAGACACCGTC -> TACTATGAAGACACCGTCT
GTACTCTTACAACGTGGTC -> TACTCTTACAACGTGGTCA
GTACTTGATAGCGGTTGGG -> TACTTGATAGCGGTTGGGC
GTAGAAGAAGCATTCTATA -> TAGAAGAAGCATTCTATAC
GTAGCCTTACAAAAGACTG -> TAGCCTTACAAAAGACTGA
GTAGCGGTCCCACACTTAC -> TAGCGGTCCCACACTTACA
GTAGGATACAGTCGACCTC -> TAGGATACAGTCGACCTCT
GTAGGTAGTAGTTTTGCTA -> TAGGTAGTAGTTTTGCTAC
GTAGGTTGATTTGAGGTGC -> TAGGTTGATTTGAGGTGCT
GTAGTAGTTTTGCTACAGG -> TAGTAGTTTTGCTACAGGA
GTAGTGGCTAAAATAAATA -> TAGTGGCTAAAATAAATAT
GTAGTTTATCCGCCACGCC -> TAGTTTATCCGCCACGCCG
GTAGTTTTGCTACAGGATA -> TAGTTTTGCTACAGGATAT
GTATCCAAGAAGCGTTGAT -> TATCCAAGAAGCGTTGATC
GTATCGAAGTACGGGAACG -> TATCGAAGTACGGGAACGC
GTATCTATAGTACTCTTAC -> TATCTATAGTACTCTTACA
GTATTGAGGTGCTTTCCTT -> TATTGAGGTGCTTTCCTTA
GTCAACCATTAATTTACGC -> TCAACCATTAATTTACGCC
GTCAGACACCATTACTTTA -> TCAGACACCATTACTTTAG
GTCAGCACCCGCCCTTCGG -> TCAGCACCCGCCCTTCGGA
GTCAGCGTTGCGTAGGTAG -> TCAGCGTTGCGTAGGTAGT
GTCCACTTCATGGCATCTG -> TCCACTTCATGGCATCTGG
GTCCATTTATTAGAGTATC -> TCCATTTATTAGAGTATCG
GTCCCACACTTACACGGTC -> TCCCACACTTACACGGTCG
GTCCCTTCCGACACAAGCA -> TCCCTTCCGACACAAGCAC
GTCCGAACCAGAACAGCCG -> TCCGAACCAGAACAGCCGA
GTCCGACACTATCTGACAT -> TCCGACACTATCTGACATA
GTCCGCGTCCTGGGTCGCG -> TCCGCGTCCTGGGTCGCGG
GTCCGGAAGCATAGACCAA -> TCCGGAAGCATAGACCAAG
GTCCTCCGACCTAGAGGGA -> TCCTCCGACCTAGAGGGAA
GTCCTGGGTCGCGGATATG -> TCCTGGGTCGCGGATATGG
GTCCTTCCCACTCGCGCTA -> TCCTTCCCACTCGCGCTAG
GTCGAAACGAAGGCATTCA -> TCGAAACGAAGGCATTCAA
GTCGACCTCTCAACGTTGC -> TCGACCTCTCAACGTTGCT
GTCGAGATGCGCTGCACAA -> TCGAGATGCGCTGCACAAC
GTCGATACCTGCAGGGTAT -> TCGATACCTGCAGGGTATC
GTCGCCGTTTTCTTGGCAC -> TCGCCGTTTTCTTGGCACA
GTCGCGGATATGGTTATAT -> TCGCGGATATGGTTATATA
GTCGCTAGTACCTACAGTT -> TCGCTAGTACCTACAGTTA
GTCGGCTTCTCTGTCCACT -> TCGGCTTCTCTGTCCACTT
GTCGGGCGATGCTCCAAGG -> TCGGGCGATGCTCCAAGGA
GTCGTGCCCTGGTTATGTT -> TCGTGCCCTGGTTATGTTA
GTCTAAGGCCCGACCTGAC -> TCTAAGGCCCGACCTGACG
GTCTACGTGCGGGACAGAT -> TCTACGTGCGGGACAGATC
GTCTCAACTTGAGGTTTGC -> TCTCAACTTGAGGTTTGCT
GTCTCTAAACCACGCTGCT -> TCTCTAAACCACGCTGCTA
GTCTGTGGTGGGCGGTGTA -> TCTGTGGTGGGCGGTGTAC
GTCTTCGCCATTATTGCCG -> TCTTCGCCATTATTGCCGA
GTGAATTCGACGGGGTCGG -> TGAATTCGACGGGGTCGGG
GTGAGCTACTGAATAAGTC -> TGAGCTACTGAATAAGTCG
GTGAGGTGTCCCTTCCGAC -> TGAGGTGTCCCTTCCGACA
GTGAGTGGGAAGTACGGTG -> TGAGTGGGAAGTACGGTGC
GTGATTGACCTTCGTTTAG -> TGATTGACCTTCGTTTAGC
GTGCAATGTTCCTAGCCCG -> TGCAATGTTCCTAGCCCGG
GTGCAATTCTAGATTCCCA -> TGCAATTCTAGATTCCCAG
GTGCAGCTAGCGTAATCTG -> TGCAGCTAGCGTAATCTGG
GTGCATAAGGGTATTGAGG -> TGCATAAGGGTATTGAGGT
GTGCCATGGATGATACGGA -> TGCCATGGATGATACGGAC
GTGCCCTGGTTATGTTAAC -> TGCCCTGGTTATGTTAACC
GTGCCGCCAACCACGTTGG -> TGCCGCCAACCACGTTGGA
GTGCGGGACAGATCGTGGT -> TGCGGGACAGATCGTGGTC
GTGCTGGCGCCATCCCTAA -> TGCTGGCGCCATCCCTAAC
GTGCTTTCCTTAATTGTGT -> TGCTTTCCTTAATTGTGTC
GTGGAGGCCCTACGAGACT -> TGGAGGCCCTACGAGACTT
GTGGCCTTACATTCATCCC -> TGGCCTTACATTCATCCCT
GTGGCTAAAATAAATATAT -> TGGCTAAAATAAATATATC
GTGGGAAGTACGGTGCAGC -> TGGGAAGTACGGTGCAGCT
GTGGGCGGTGTACCATCAA -> TGGGCGGTGTACCATCAAC,TGGGCGGTGTACCATCAAC
GTGGGTAAACTTAAGGGAG -> TGGGTAAACTTAAGGGAGG
GTGGTCAGACACCATTACT -> TGGTCAGACACCATTACTT
GTGGTCCTTCCCACTCGCG -> TGGTCCTTCCCACTCGCGC
GTGGTGGGCGGTGTACCAT -> TGGTGGGCGGTGTACCATC
GTGTAAAGCAATAAATGTA -> TGTAAAGCAATAAATGTAC
GTGTACCATCAACCGCAGG -> TGTACCATCAACCGCAGGT
GTGTACCATCAACGAAGGC -> TGTACCATCAACGAAGGCC
GTGTACCATCAACTCTTCT -> TGTACCATCAACTCTTCTC
GTGTACCATCAACTGCTCG -> TGTACCATCAACTGCTCGA
GTGTCCCTTCCGACACAAG -> TGTCCCTTCCGACACAAGC
GTGTCCGGAAGCATAGACC -> TGTCCGGAAGCATAGACCA
GTGTGAATTCGACGGGGTC -> TGTGAATTCGACGGGGTCG
GTGTGGGTAAACTTAAGGG -> TGTGGGTAAACTTAAGGGA
GTGTGTGAATTCGACGGGG -> TGTGTGAATTCGACGGGGT
GTGTTGCCCCCGATTTCGA -> TGTTGCCCCCGATTTCGAG
GTTAACCGAATTTTCATAT -> TTAACCGAATTTTCATATG
GTTACCGATCTGCCGGGCC -> TTACCGATCTGCCGGGCCC
GTTATATACACGTTTAAGG -> TTATATACACGTTTAAGGC
GTTATGTTAACCGAATTTT -> TTATGTTAACCGAATTTTC
GTTCCTAGCCCGGTCTCTA -> TTCCTAGCCCGGTCTCTAA
GTTCTGGACGGCCTTGCAG -> TTCTGGACGGCCTTGCAGA
GTTGAACTAGGGAGGCCGA -> TTGAACTAGGGAGGCCGAG
GTTGATCGTACCGTCTTCG -> TTGATCGTACCGTCTTCGC
GTTGATTTGAGGTGCTGGC -> TTGATTTGAGGTGCTGGCG
GTTGCCCCCGATTTCGAGC -> TTGCCCCCGATTTCGAGCA
GTTGCGTAGGTAGTAGTTT -> TTGCGTAGGTAGTAGTTTT
GTTGCTTCCAGACATCGTA -> TTGCTTCCAGACATCGTAG
GTTGGACCGGGTAGCGGTC -> TTGGACCGGGTAGCGGTCC
GTTGGGCGGTGTACCATCA -> TTGGGCGGTGTACCATCAA,TTGGGCGGTGTACCATCAA
GTTGTCAGCACCCGCCCTT -> TTGTCAGCACCCGCCCTTC
GTTTAAGGCGTAATGACTT -> TTTAAGGCGTAATGACTTC
GTTTATCCGCCACGCCGGC -> TTTATCCGCCACGCCGGCC
GTTTCGACACAATGGCTGT -> TTTCGACACAATGGCTGTA
GTTTGCTGTCGAAACGAAG -> TTTGCTGTCGAAACGAAGG
GTTTTAGCCGCGGGCAACG -> TTTTAGCCGCGGGCAACGA
GTTTTCTTGGCACACTGAT -> TTTTCTTGGCACACTGATA
GTTTTGCTACAGGATATGA -> TTTTGCTACAGGATATGAT
TAAAAAACCTGCGGACACC -> AAAAAACCTGCGGACACCT
TAAAAATTTTTGTCCTCCG -> AAAAATTTTTGTCCTCCGA
TAAAAGGTACAAGCATACG -> AAAAGGTACAAGCATACGC
TAAAATAAATATATCCAAA -> AAAATAAATATATCCAAAG
TAAACAGCCCAACATTATT -> AAACAGCCCAACATTATTT
TAAACCACGCTGCTAAAAA -> AAACCACGCTGCTAAAAAA
TAAACTAGTCGCCGTTTTC -> AAACTAGTCGCCGTTTTCT
TAAACTTAAGGGAGGTGAG -> AAACTTAAGGGAGGTGAGC
TAAAGCAATAAATGTACGG -> AAAGCAATAAATGTACGGC
TAAAGGAATCAGACCCCAG -> AAAGGAATCAGACCCCAGA
TAAATATATCCAAAGCGGG -> AAATATATCCAAAGCGGGA
TAAATCGAGCACTCCGGGC -> AAATCGAGCACTCCGGGCT
TAAATGTACGGCGCGTCCG -> AAATGTACGGCGCGTCCGC
TAACAATGATCGGGTGCAA -> AACAATGATCGGGTGCAAT
TAACCGAATTTTCATATGG -> AACCGAATTTTCATATGGC
TAACCTAGGTGTGGGTAAA -> AACCTAGGTGTGGGTAAAC
TAACGGGCTTGTGCATAAG -> AACGGGCTTGTGCATAAGG
TAACTGTCGAGATGCGCTG -> AACTGTCGAGATGCGCTGC
TAACTTAATGCGCAACGGT -> AACTTAATGCGCAACGGTC
TAAGGCCCGACCTGACGTA -> AAGGCCCGACCTGACGTAG
TAAGGCGTAATGACTTCAA -> AAGGCGTAATGACTTCAAA
TAAGGCGTCTAAGGCCCGA -> AAGGCGTCTAAGGCCCGAC
TAAGGGAGGTGAGCTACTG -> AAGGGAGGTGAGCTACTGA
TAAGGGTATTGAGGTGCTT -> AAGGGTATTGAGGTGCTTT
TAAGTCGATACCTGCAGGG -> AAGTCGATACCTGCAGGGT
TAAGTCGCTAGTACCTACA -> AAGTCGCTAGTACCTACAG
TAATCTGGACGGATCCTGC -> AATCTGGACGGATCCTGCC
TAATGACTTCAAAGACATT -> AATGACTTCAAAGACATTG
TAATGCGCAACGGTCCGAA -> AATGCGCAACGGTCCGAAC
TAATTACTGAAGGATTAGG -> AATTACTGAAGGATTAGGC
TAATTGTGTCCGGAAGCAT -> AATTGTGTCCGGAAGCATA
TAATTTACGCCGAGCTCCT -> AATTTACGCCGAGCTCCTC
TACAAAAGACTGATAGCCG -> ACAAAAGACTGATAGCCGG
TACAAACGGACCGTTGGGC -> ACAAACGGACCGTTGGGCG
TACAACGTGGTCAGACACC -> ACAACGTGGTCAGACACCA
TACAAGCATACGCCGTAAA -> ACAAGCATACGCCGTAAAT
TACAAGTGAGTGGGAAGTA -> ACAAGTGAGTGGGAAGTAC
TACAATACACGCCTAGTTC -> ACAATACACGCCTAGTTCT
TACACGCCTAGTTCTGGAC -> ACACGCCTAGTTCTGGACG
TACACGGTCGGCTTCTCTG -> ACACGGTCGGCTTCTCTGT
TACACGTTTAAGGCGTAAT -> ACACGTTTAAGGCGTAATG
TACAGCGCTAACTTAATGC -> ACAGCGCTAACTTAATGCG
TACAGGATATGATTTGACT -> ACAGGATATGATTTGACTC
TACAGTCGACCTCTCAACG -> ACAGTCGACCTCTCAACGT
TACAGTTACCGATCTGCCG -> ACAGTTACCGATCTGCCGG
TACATTCATCCCTCAACCA -> ACATTCATCCCTCAACCAT
TACCAAGGGCGCTCGCAGG -> ACCAAGGGCGCTCGCAGGC
TACCATCAACCGCAGGTAA -> ACCATCAACCGCAGGTAAC
TACCATCAACGAAGGCCTG -> ACCATCAACGAAGGCCTGT
TACCATCAACTCTTCTCGG -> ACCATCAACTCTTCTCGGG
TACCATCAACTGCTCGAAC -> ACCATCAACTGCTCGAACT
TACCGATCTGCCGGGCCCA -> ACCGATCTGCCGGGCCCAG
TACCGATTTCGAGCATGTA -> ACCGATTTCGAGCATGTAC
TACCGTCTTCGCCATTATT -> ACCGTCTTCGCCATTATTG
TACCTACAGTTACCGATCT -> ACCTACAGTTACCGATCTG
TACCTACGTTGTCAGCACC -> ACCTACGTTGTCAGCACCC
TACCTGCAGGGTATCCAAG -> ACCTGCAGGGTATCCAAGA
TACCTTGTCTGTGGTGGGC -> ACCTTGTCTGTGGTGGGCG
TACGAGACTTCCTGTGTTG -> ACGAGACTTCCTGTGTTGC
TACGATACGTGGGCGGTGT -> ACGATACGTGGGCGGTGTA
TACGCCGAGCTCCTCCGGA -> ACGCCGAGCTCCTCCGGAA
TACGCCGTAAATCGAGCAC -> ACGCCGTAAATCGAGCACT
TACGCTACGATACGTGGGC -> ACGCTACGATACGTGGGCG
TACGCTCACAGCGCGCGGC -> ACGCTCACAGCGCGCGGCT
TACGGACGAGTTTTAGCCG -> ACGGACGAGTTTTAGCCGC
TACGGCGCGTCCGCGTCCT -> ACGGCGCGTCCGCGTCCTG
TACGGGAACGCCGGGAGAG -> ACGGGAACGCCGGGAGAGG
TACGGTGCAGCTAGCGTAA -> ACGGTGCAGCTAGCGTAAT
TACGTGCGGGACAGATCGT -> ACGTGCGGGACAGATCGTG
TACGTGGGCGGTGTACCAT -> ACGTGGGCGGTGTACCATC
TACGTTGTCAGCACCCGCC -> ACGTTGTCAGCACCCGCCC
TACTAGCAGGGCTGGGCCT -> ACTAGCAGGGCTGGGCCTA
TACTATGAAGACACCGTCT -> ACTATGAAGACACCGTCTC
TACTCTTACAACGTGGTCA -> ACTCTTACAACGTGGTCAG
TACTGAAGGATTAGGCTGT -> ACTGAAGGATTAGGCTGTT
TACTGAATAAGTCGCTAGT -> ACTGAATAAGTCGCTAGTA
TACTTCACAACGGCAATGA -> ACTTCACAACGGCAATGAC
TACTTGATAGCGGTTGGGC -> ACTTGATAGCGGTTGGGCG
TACTTTAGCTCGGCTCCGA -> ACTTTAGCTCGGCTCCGAT
TAGAAGAAGCATTCTATAC -> AGAAGAAGCATTCTATACA
TAGACCAAGGCTGTCAGCG -> AGACCAAGGCTGTCAGCGT
TAGAGGGAATGGTAAACAG -> AGAGGGAATGGTAAACAGC
TAGAGTATCGAAGTACGGG -> AGAGTATCGAAGTACGGGA
TAGATTCCAATGGCCGGCC -> AGATTCCAATGGCCGGCCG
TAGATTCCCAGGACGGGCA -> AGATTCCCAGGACGGGCAT
TAGCACGCAAAAGGGGGAA -> AGCACGCAAAAGGGGGAAG
TAGCAGGGCTGGGCCTAAA -> AGCAGGGCTGGGCCTAAAA
TAGCCCGGTCTCTAAACCA -> AGCCCGGTCTCTAAACCAC
TAGCCGCGGGCAACGAGAT -> AGCCGCGGGCAACGAGATG
TAGCCGGTCAACCATTAAT -> AGCCGGTCAACCATTAATT
TAGCCTTACAAAAGACTGA -> AGCCTTACAAAAGACTGAT
TAGCGGTCCCACACTTACA -> AGCGGTCCCACACTTACAC
TAGCGGTTGGGCGGTGTAC -> AGCGGTTGGGCGGTGTACC
TAGCGTAATCTGGACGGAT -> AGCGTAATCTGGACGGATC
TAGCTCGGCTCCGATTTCG -> AGCTCGGCTCCGATTTCGA
TAGGAGCCTGACACCGTCG -> AGGAGCCTGACACCGTCGT
TAGGATACAGTCGACCTCT -> AGGATACAGTCGACCTCTC
TAGGCTGTTGAACTAGGGA -> AGGCTGTTGAACTAGGGAG
TAGGGAGGCCGAGCACGGG -> AGGGAGGCCGAGCACGGGT
TAGGTAGTAGTTTTGCTAC -> AGGTAGTAGTTTTGCTACA
TAGGTGTGGGTAAACTTAA -> AGGTGTGGGTAAACTTAAG
TAGGTTGATTTGAGGTGCT -> AGGTTGATTTGAGGTGCTG
TAGTACCTACAGTTACCGA -> AGTACCTACAGTTACCGAT
TAGTACTCTTACAACGTGG -> AGTACTCTTACAACGTGGT
TAGTAGTTTTGCTACAGGA -> AGTAGTTTTGCTACAGGAT
TAGTCGCCGTTTTCTTGGC -> AGTCGCCGTTTTCTTGGCA
TAGTGGCTAAAATAAATAT -> AGTGGCTAAAATAAATATA
TAGTGTAAAGCAATAAATG -> AGTGTAAAGCAATAAATGT
TAGTTCTGGACGGCCTTGC -> AGTTCTGGACGGCCTTGCA
TAGTTTATCCGCCACGCCG -> AGTTTATCCGCCACGCCGG
TAGTTTTGCTACAGGATAT -> AGTTTTGCTACAGGATATG
TATACAAGTGAGTGGGAAG -> ATACAAGTGAGTGGGAAGT
TATACACGTTTAAGGCGTA -> ATACACGTTTAAGGCGTAA
TATACAGCGCTAACTTAAT -> ATACAGCGCTAACTTAATG
TATAGCACGCAAAAGGGGG -> ATAGCACGCAAAAGGGGGA
TATAGTACTCTTACAACGT -> ATAGTACTCTTACAACGTG
TATATACACGTTTAAGGCG -> ATATACACGTTTAAGGCGT
TATATCCAAAGCGGGAAAA -> ATATCCAAAGCGGGAAAAG
TATCCAAAGCGGGAAAAGG -> ATCCAAAGCGGGAAAAGGC
TATCCAAGAAGCGTTGATC -> ATCCAAGAAGCGTTGATCG
TATCCGCCACGCCGGCCAA -> ATCCGCCACGCCGGCCAAG
TATCGAAGTACGGGAACGC -> ATCGAAGTACGGGAACGCC
TATCTATAGTACTCTTACA -> ATCTATAGTACTCTTACAA
TATCTGACATATAGCACGC -> ATCTGACATATAGCACGCA
TATGAAGACACCGTCTCAA -> ATGAAGACACCGTCTCAAC
TATGATTTGACTCCCCTAT -> ATGATTTGACTCCCCTATG
TATGCGTAGTTTATCCGCC -> ATGCGTAGTTTATCCGCCA
TATGGCAATGAGAAGTGAG -> ATGGCAATGAGAAGTGAGG
TATGGTTATATACACGTTT -> ATGGTTATATACACGTTTA
TATGTATCTATAGTACTCT -> ATGTATCTATAGTACTCTT
TATGTTAACCGAATTTTCA -> ATGTTAACCGAATTTTCAT
TATTAGAGTATCGAAGTAC -> ATTAGAGTATCGAAGTACG
TATTGAGGTGCTTTCCTTA -> ATTGAGGTGCTTTCCTTAA
TATTGCCGACAGATCAGTC -> ATTGCCGACAGATCAGTCC
TATTTTAACAATGATCGGG -> ATTTTAACAATGATCGGGT
TCAAAGACATTGGCACAAC -> CAAAGACATTGGCACAACT
TCAACCATAGGAGCCTGAC -> CAACCATAGGAGCCTGACA
TCAACCATTAATTTACGCC -> CAACCATTAATTTACGCCG
TCAACCGCAGGTAACCTAG -> CAACCGCAGGTAACCTAGG
TCAACGAAGGCCTGTGGAG -> CAACGAAGGCCTGTGGAGG
TCAACGTTGCTTCCAGACA -> CAACGTTGCTTCCAGACAT
TCAACTCTTCTCGGGCGAT -> CAACTCTTCTCGGGCGATT
TCAACTGCTCGAACTAAAG -> CAACTGCTCGAACTAAAGG
TCAACTTCCTTGCGCTACG -> CAACTTCCTTGCGCTACGC
TCAACTTGAGGTTTGCTGT -> CAACTTGAGGTTTGCTGTC
TCAAGAGCCCGCAGCCCAT -> CAAGAGCCCGCAGCCCATC
TCACAACGGCAATGACTGG -> CACAACGGCAATGACTGGA
TCACAGCGCGCGGCTCTGA -> CACAGCGCGCGGCTCTGAG
TCACTCGCTGCAGCTGAAA -> CACTCGCTGCAGCTGAAAG
TCACTGTGCCATGGATGAT -> CACTGTGCCATGGATGATA
TCAGACACCATTACTTTAG -> CAGACACCATTACTTTAGC
TCAGACCCCAGAGATTAAT -> CAGACCCCAGAGATTAATT
TCAGCACCCGCCCTTCGGA -> CAGCACCCGCCCTTCGGAT
TCAGCGTTGCGTAGGTAGT -> CAGCGTTGCGTAGGTAGTA
TCAGGTAGTGGCTAAAATA -> CAGGTAGTGGCTAAAATAA
TCAGTCCATTTATTAGAGT -> CAGTCCATTTATTAGAGTA
TCATACCGATTTCGAGCAT -> CATACCGATTTCGAGCATG
TCATATGGCAATGAGAAGT -> CATATGGCAATGAGAAGTG
TCATCCCTCAACCATAGGA -> CATCCCTCAACCATAGGAG
TCATGGCATCTGGCAGTCT -> CATGGCATCTGGCAGTCTA
TCCAAAGCGGGAAAAGGCT -> CCAAAGCGGGAAAAGGCTC
TCCAAGAAGCGTTGATCGT -> CCAAGAAGCGTTGATCGTA
TCCAAGGAAGACGAAAGTA -> CCAAGGAAGACGAAAGTAA
TCCAATGGCCGGCCGGGAA -> CCAATGGCCGGCCGGGAAC
TCCACTTCATGGCATCTGG -> CCACTTCATGGCATCTGGC
TCCAGACATCGTAGGTTGA -> CCAGACATCGTAGGTTGAT
TCCAGCCCCATTACCAAGG -> CCAGCCCCATTACCAAGGG
TCCATTTATTAGAGTATCG -> CCATTTATTAGAGTATCGA
TCCCACACTTACACGGTCG -> CCCACACTTACACGGTCGG
TCCCACTCGCGCTAGATTC -> CCCACTCGCGCTAGATTCC
TCCCAGGACGGGCATATAC -> CCCAGGACGGGCATATACA
TCCCCTATGTATCTATAGT -> CCCCTATGTATCTATAGTA
TCCCTAACTGTCGAGATGC -> CCCTAACTGTCGAGATGCG
TCCCTCAACCATAGGAGCC -> CCCTCAACCATAGGAGCCT
TCCCTTCCGACACAAGCAC -> CCCTTCCGACACAAGCACT
TCCGAACCAGAACAGCCGA -> CCGAACCAGAACAGCCGAT
TCCGACACAAGCACTTCCG -> CCGACACAAGCACTTCCGA
TCCGACACTATCTGACATA -> CCGACACTATCTGACATAT
TCCGACCTAGAGGGAATGG -> CCGACCTAGAGGGAATGGT
TCCGAGACTACTTCACAAC -> CCGAGACTACTTCACAACG
TCCGATTTCGAGCATGTAC -> CCGATTTCGAGCATGTACT
TCCGCCACGCCGGCCAAGG -> CCGCCACGCCGGCCAAGGT
TCCGCGTCCTGGGTCGCGG -> CCGCGTCCTGGGTCGCGGA
TCCGGAAACTAAGGCGTCT -> CCGGAAACTAAGGCGTCTA
TCCGGAAGCATAGACCAAG -> CCGGAAGCATAGACCAAGG
TCCGGGCTTGCTCTGCACC -> CCGGGCTTGCTCTGCACCC
TCCTAGCCCGGTCTCTAAA -> CCTAGCCCGGTCTCTAAAC
TCCTCCGACCTAGAGGGAA -> CCTCCGACCTAGAGGGAAT
TCCTCCGGAAACTAAGGCG -> CCTCCGGAAACTAAGGCGT
TCCTGCCTAGTGTAAAGCA -> CCTGCCTAGTGTAAAGCAA
TCCTGGGTCGCGGATATGG -> CCTGGGTCGCGGATATGGT
TCCTGTGTTGCCCCCGATT -> CCTGTGTTGCCCCCGATTT
TCCTTAATTGTGTCCGGAA -> CCTTAATTGTGTCCGGAAG
TCCTTCCCACTCGCGCTAG -> CCTTCCCACTCGCGCTAGA
TCCTTGCGCTACGCTCACA -> CCTTGCGCTACGCTCACAG
TCGAAACGAAGGCATTCAA -> CGAAACGAAGGCATTCAAG
TCGAACTAAAGGAATCAGA -> CGAACTAAAGGAATCAGAC
TCGAAGTACGGGAACGCCG -> CGAAGTACGGGAACGCCGG
TCGACACAATGGCTGTAGG -> CGACACAATGGCTGTAGGA
TCGACCTCTCAACGTTGCT -> CGACCTCTCAACGTTGCTT
TCGACGGGGTCGGGCGATG -> CGACGGGGTCGGGCGATGC
TCGAGATGCGCTGCACAAC -> CGAGATGCGCTGCACAACC
TCGAGCACTCCGGGCTTGC -> CGAGCACTCCGGGCTTGCT
TCGAGCATGTACAAACGGA -> CGAGCATGTACAAACGGAC
TCGAGCATGTACCTTGTCT -> CGAGCATGTACCTTGTCTG
TCGAGCATGTACGCTACGA -> CGAGCATGTACGCTACGAT
TCGAGCATGTACTTGATAG -> CGAGCATGTACTTGATAGC
TCGATACCTGCAGGGTATC -> CGATACCTGCAGGGTATCC
TCGCAGGCCGCATTGTGTG -> CGCAGGCCGCATTGTGTGT
TCGCCACCAATCAACTTCC -> CGCCACCAATCAACTTCCT
TCGCCATTATTGCCGACAG -> CGCCATTATTGCCGACAGA
TCGCCGTTTTCTTGGCACA -> CGCCGTTTTCTTGGCACAC
TCGCGCTAGATTCCAATGG -> CGCGCTAGATTCCAATGGC
TCGCGGATATGGTTATATA -> CGCGGATATGGTTATATAC
TCGCTAGTACCTACAGTTA -> CGCTAGTACCTACAGTTAC
TCGCTGCAGCTGAAAGTGC -> CGCTGCAGCTGAAAGTGCC
TCGGATAAAAGGTACAAGC -> CGGATAAAAGGTACAAGCA
TCGGCTCCGATTTCGAGCA -> CGGCTCCGATTTCGAGCAT
TCGGCTTCTCTGTCCACTT -> CGGCTTCTCTGTCCACTTC
TCGGGCGATGCTCCAAGGA -> CGGGCGATGCTCCAAGGAA
TCGGGCGATTGCGTAAGTC -> CGGGCGATTGCGTAAGTCG
TCGGGTGCAATGTTCCTAG -> CGGGTGCAATGTTCCTAGC
TCGTACCGTCTTCGCCATT -> CGTACCGTCTTCGCCATTA
TCGTAGCCTTACAAAAGAC -> CGTAGCCTTACAAAAGACT
TCGTAGGTTGATTTGAGGT -> CGTAGGTTGATTTGAGGTG
TCGTGCCCTGGTTATGTTA -> CGTGCCCTGGTTATGTTAA
TCGTGGTCCTTCCCACTCG -> CGTGGTCCTTCCCACTCGC
TCTAAACCACGCTGCTAAA -> CTAAACCACGCTGCTAAAA
TCTAAGGCCCGACCTGACG -> CTAAGGCCCGACCTGACGT
TCTACGTGCGGGACAGATC -> CTACGTGCGGGACAGATCG
TCTAGATTCCCAGGACGGG -> CTAGATTCCCAGGACGGGC
TCTATACAAGTGAGTGGGA -> CTATACAAGTGAGTGGGAA
TCTATAGTACTCTTACAAC -> CTATAGTACTCTTACAACG
TCTCAACGTTGCTTCCAGA -> CTCAACGTTGCTTCCAGAC
TCTCAACTTGAGGTTTGCT -> CTCAACTTGAGGTTTGCTG
TCTCACTCGCTGCAGCTGA -> CTCACTCGCTGCAGCTGAA
TCTCGGGCGATTGCGTAAG -> CTCGGGCGATTGCGTAAGT
TCTCTAAACCACGCTGCTA -> CTCTAAACCACGCTGCTAA
TCTCTGTCCACTTCATGGC -> CTCTGTCCACTTCATGGCA
TCTGACATATAGCACGCAA -> CTGACATATAGCACGCAAA
TCTGAGGCATTTCTCACTC -> CTGAGGCATTTCTCACTCG
TCTGCACCCTGCAAAGGCG -> CTGCACCCTGCAAAGGCGG
TCTGCCGGGCCCAGGGTGC -> CTGCCGGGCCCAGGGTGCA
TCTGGACGGATCCTGCCTA -> CTGGACGGATCCTGCCTAG
TCTGGACGGCCTTGCAGAG -> CTGGACGGCCTTGCAGAGC
TCTGGCAGTCTACGTGCGG -> CTGGCAGTCTACGTGCGGG
TCTGTCCACTTCATGGCAT -> CTGTCCACTTCATGGCATC
TCTGTGGTGGGCGGTGTAC -> CTGTGGTGGGCGGTGTACC
TCTTAACGGGCTTGTGCAT -> CTTAACGGGCTTGTGCATA
TCTTACAACGTGGTCAGAC -> CTTACAACGTGGTCAGACA
TCTTCGCCATTATTGCCGA -> CTTCGCCATTATTGCCGAC
TCTTCTCGGGCGATTGCGT -> CTTCTCGGGCGATTGCGTA
TCTTGGCACACTGATACTA -> CTTGGCACACTGATACTAG
TGAAAGTGCCGCCAACCAC -> GAAAGTGCCGCCAACCACG
TGAACTAGGGAGGCCGAGC -> GAACTAGGGAGGCCGAGCA
TGAAGACACCGTCTCAACT -> GAAGACACCGTCTCAACTT
TGAAGATCCAGCCCCATTA -> GAAGATCCAGCCCCATTAC
TGAAGGATTAGGCTGTTGA -> GAAGGATTAGGCTGTTGAA
TGAATAAGTCGCTAGTACC -> GAATAAGTCGCTAGTACCT
TGAATTCGACGGGGTCGGG -> GAATTCGACGGGGTCGGGC
TGACACCGTCGTGCCCTGG -> GACACCGTCGTGCCCTGGT
TGACATATAGCACGCAAAA -> GACATATAGCACGCAAAAG
TGACGTAGAAGAAGCATTC -> GACGTAGAAGAAGCATTCT
TGACTCCCCTATGTATCTA -> GACTCCCCTATGTATCTAT
TGACTGGAATGCATCTTAA -> GACTGGAATGCATCTTAAC
TGACTTCAAAGACATTGGC -> GACTTCAAAGACATTGGCA
TGAGAAGTGAGGTGTCCCT -> GAGAAGTGAGGTGTCCCTT
TGAGCTACTGAATAAGTCG -> GAGCTACTGAATAAGTCGC
TGAGGCATTTCTCACTCGC -> GAGGCATTTCTCACTCGCT
TGAGGTGCTGGCGCCATCC -> GAGGTGCTGGCGCCATCCC
TGAGGTGCTTTCCTTAATT -> GAGGTGCTTTCCTTAATTG
TGAGGTGTCCCTTCCGACA -> GAGGTGTCCCTTCCGACAC
TGAGGTTTGCTGTCGAAAC -> GAGGTTTGCTGTCGAAACG
TGAGTGGGAAGTACGGTGC -> GAGTGGGAAGTACGGTGCA
TGATACGGACGAGTTTTAG -> GATACGGACGAGTTTTAGC
TGATACTAGCAGGGCTGGG -> GATACTAGCAGGGCTGGGC
TGATAGCCGGTCAACCATT -> GATAGCCGGTCAACCATTA
TGATAGCGGTTGGGCGGTG -> GATAGCGGTTGGGCGGTGT
TGATCGGGTGCAATGTTCC -> GATCGGGTGCAATGTTCCT
TGATCGTACCGTCTTCGCC -> GATCGTACCGTCTTCGCCA
TGATTGACCTTCGTTTAGC -> GATTGACCTTCGTTTAGCC
TGATTTGACTCCCCTATGT -> GATTTGACTCCCCTATGTA
TGATTTGAGGTGCTGGCGC -> GATTTGAGGTGCTGGCGCC
TGCAAAGGCGGGTTTCGAC -> GCAAAGGCGGGTTTCGACA
TGCAATGTTCCTAGCCCGG -> GCAATGTTCCTAGCCCGGT
TGCAATTCTAGATTCCCAG -> GCAATTCTAGATTCCCAGG
TGCACAACCAAGACCTATG -> GCACAACCAAGACCTATGC
TGCACCCTGCAAAGGCGGG -> GCACCCTGCAAAGGCGGGT
TGCAGAGCTTCGCCACCAA -> GCAGAGCTTCGCCACCAAT
TGCAGCTAGCGTAATCTGG -> GCAGCTAGCGTAATCTGGA
TGCAGCTGAAAGTGCCGCC -> GCAGCTGAAAGTGCCGCCA
TGCAGGGTATCCAAGAAGC -> GCAGGGTATCCAAGAAGCG
TGCATAAGGGTATTGAGGT -> GCATAAGGGTATTGAGGTG
TGCATCTTAACGGGCTTGT -> GCATCTTAACGGGCTTGTG
TGCCATGGATGATACGGAC -> GCCATGGATGATACGGACG
TGCCCCCGATTTCGAGCAT -> GCCCCCGATTTCGAGCATG
TGCCCTGGTTATGTTAACC -> GCCCTGGTTATGTTAACCG
TGCCGACAGATCAGTCCAT -> GCCGACAGATCAGTCCATT
TGCCGCCAACCACGTTGGA -> GCCGCCAACCACGTTGGAC
TGCCGGGCCCAGGGTGCAA -> GCCGGGCCCAGGGTGCAAT
TGCCTAGTGTAAAGCAATA -> GCCTAGTGTAAAGCAATAA
TGCGCAACGGTCCGAACCA -> GCGCAACGGTCCGAACCAG
TGCGCTACGCTCACAGCGC -> GCGCTACGCTCACAGCGCG
TGCGCTGCACAACCAAGAC -> GCGCTGCACAACCAAGACC
TGCGGACACCTACCTACGT -> GCGGACACCTACCTACGTT
TGCGGGACAGATCGTGGTC -> GCGGGACAGATCGTGGTCC
TGCGTAAGTCGATACCTGC -> GCGTAAGTCGATACCTGCA
TGCGTAGGTAGTAGTTTTG -> GCGTAGGTAGTAGTTTTGC
TGCGTAGTTTATCCGCCAC -> GCGTAGTTTATCCGCCACG
TGCTAAAAAACCTGCGGAC -> GCTAAAAAACCTGCGGACA
TGCTACAGGATATGATTTG -> GCTACAGGATATGATTTGA
TGCTCCAAGGAAGACGAAA -> GCTCCAAGGAAGACGAAAG
TGCTCGAACTAAAGGAATC -> GCTCGAACTAAAGGAATCA
TGCTCTGCACCCTGCAAAG -> GCTCTGCACCCTGCAAAGG
TGCTGGCGCCATCCCTAAC -> GCTGGCGCCATCCCTAACT
TGCTGTCGAAACGAAGGCA -> GCTGTCGAAACGAAGGCAT
TGCTTCCAGACATCGTAGG -> GCTTCCAGACATCGTAGGT
TGCTTTCCTTAATTGTGTC -> GCTTTCCTTAATTGTGTCC
TGGAATGCATCTTAACGGG -> GGAATGCATCTTAACGGGC
TGGACCGGGTAGCGGTCCC -> GGACCGGGTAGCGGTCCCA
TGGACGGATCCTGCCTAGT -> GGACGGATCCTGCCTAGTG
TGGACGGCCTTGCAGAGCT -> GGACGGCCTTGCAGAGCTT
TGGAGGCCCTACGAGACTT -> GGAGGCCCTACGAGACTTC
TGGATGATACGGACGAGTT -> GGATGATACGGACGAGTTT
TGGCAATGAGAAGTGAGGT -> GGCAATGAGAAGTGAGGTG
TGGCACAACTCAGGTAGTG -> GGCACAACTCAGGTAGTGG
TGGCACACTGATACTAGCA -> GGCACACTGATACTAGCAG
TGGCAGTCTACGTGCGGGA -> GGCAGTCTACGTGCGGGAC
TGGCATCTGGCAGTCTACG -> GGCATCTGGCAGTCTACGT
TGGCCGGCCGGGAACATTT -> GGCCGGCCGGGAACATTTC
TGGCCTTACATTCATCCCT -> GGCCTTACATTCATCCCTC
TGGCGCCATCCCTAACTGT -> GGCGCCATCCCTAACTGTC
TGGCTAAAATAAATATATC -> GGCTAAAATAAATATATCC
TGGCTGTAGGATACAGTCG -> GGCTGTAGGATACAGTCGA
TGGGAAGTACGGTGCAGCT -> GGGAAGTACGGTGCAGCTA
TGGGCCTAAAAATTTTTGT -> GGGCCTAAAAATTTTTGTC
TGGGCGGTGTACCATCAAC -> GGGCGGTGTACCATCAACC,GGGCGGTGTACCATCAACG,GGGCGGTGTACCATCAACT,GGGCGGTGTACCATCAACT
TGGGTAAACTTAAGGGAGG -> GGGTAAACTTAAGGGAGGT
TGGGTCGCGGATATGGTTA -> GGGTCGCGGATATGGTTAT
TGGTAAACAGCCCAACATT -> GGTAAACAGCCCAACATTA
TGGTCAGACACCATTACTT -> GGTCAGACACCATTACTTT
TGGTCCTTCCCACTCGCGC -> GGTCCTTCCCACTCGCGCT
TGGTGGGCGGTGTACCATC -> GGTGGGCGGTGTACCATCA
TGGTTATATACACGTTTAA -> GGTTATATACACGTTTAAG
TGGTTATGTTAACCGAATT -> GGTTATGTTAACCGAATTT
TGTAAAGCAATAAATGTAC -> GTAAAGCAATAAATGTACG
TGTACAAACGGACCGTTGG -> GTACAAACGGACCGTTGGG
TGTACCATCAACCGCAGGT -> GTACCATCAACCGCAGGTA
TGTACCATCAACGAAGGCC -> GTACCATCAACGAAGGCCT
TGTACCATCAACTCTTCTC -> GTACCATCAACTCTTCTCG
TGTACCATCAACTGCTCGA -> GTACCATCAACTGCTCGAA
TGTACCTTGTCTGTGGTGG -> GTACCTTGTCTGTGGTGGG
TGTACGCTACGATACGTGG -> GTACGCTACGATACGTGGG
TGTACGGCGCGTCCGCGTC -> GTACGGCGCGTCCGCGTCC
TGTACTTGATAGCGGTTGG -> GTACTTGATAGCGGTTGGG
TGTAGGATACAGTCGACCT -> GTAGGATACAGTCGACCTC
TGTATCTATAGTACTCTTA -> GTATCTATAGTACTCTTAC
TGTCAGCACCCGCCCTTCG -> GTCAGCACCCGCCCTTCGG
TGTCAGCGTTGCGTAGGTA -> GTCAGCGTTGCGTAGGTAG
TGTCCACTTCATGGCATCT -> GTCCACTTCATGGCATCTG
TGTCCCTTCCGACACAAGC -> GTCCCTTCCGACACAAGCA
TGTCCGGAAGCATAGACCA -> GTCCGGAAGCATAGACCAA
TGTCCTCCGACCTAGAGGG -> GTCCTCCGACCTAGAGGGA
TGTCGAAACGAAGGCATTC -> GTCGAAACGAAGGCATTCA
TGTCGAGATGCGCTGCACA -> GTCGAGATGCGCTGCACAA
TGTCTGTGGTGGGCGGTGT -> GTCTGTGGTGGGCGGTGTA
TGTGAATTCGACGGGGTCG -> GTGAATTCGACGGGGTCGG
TGTGCATAAGGGTATTGAG -> GTGCATAAGGGTATTGAGG
TGTGCCATGGATGATACGG -> GTGCCATGGATGATACGGA
TGTGGAGGCCCTACGAGAC -> GTGGAGGCCCTACGAGACT
TGTGGGTAAACTTAAGGGA -> GTGGGTAAACTTAAGGGAG
TGTGGTGGGCGGTGTACCA -> GTGGTGGGCGGTGTACCAT
TGTGTCCGGAAGCATAGAC -> GTGTCCGGAAGCATAGACC
TGTGTGAATTCGACGGGGT -> GTGTGAATTCGACGGGGTC
TGTGTGTGAATTCGACGGG -> GTGTGTGAATTCGACGGGG
TGTGTTGCCCCCGATTTCG -> GTGTTGCCCCCGATTTCGA
TGTTAACCGAATTTTCATA -> GTTAACCGAATTTTCATAT
TGTTCCTAGCCCGGTCTCT -> GTTCCTAGCCCGGTCTCTA
TGTTGAACTAGGGAGGCCG -> GTTGAACTAGGGAGGCCGA
TGTTGCCCCCGATTTCGAG -> GTTGCCCCCGATTTCGAGC
TTAACAATGATCGGGTGCA -> TAACAATGATCGGGTGCAA
TTAACCGAATTTTCATATG -> TAACCGAATTTTCATATGG
TTAACGGGCTTGTGCATAA -> TAACGGGCTTGTGCATAAG
TTAAGGCGTAATGACTTCA -> TAAGGCGTAATGACTTCAA
TTAAGGGAGGTGAGCTACT -> TAAGGGAGGTGAGCTACTG
TTAATGCGCAACGGTCCGA -> TAATGCGCAACGGTCCGAA
TTAATTACTGAAGGATTAG -> TAATTACTGAAGGATTAGG
TTAATTGTGTCCGGAAGCA -> TAATTGTGTCCGGAAGCAT
TTAATTTACGCCGAGCTCC -> TAATTTACGCCGAGCTCCT
TTACAAAAGACTGATAGCC -> TACAAAAGACTGATAGCCG
TTACAACGTGGTCAGACAC -> TACAACGTGGTCAGACACC
TTACACGGTCGGCTTCTCT -> TACACGGTCGGCTTCTCTG
TTACATTCATCCCTCAACC -> TACATTCATCCCTCAACCA
TTACCAAGGGCGCTCGCAG -> TACCAAGGGCGCTCGCAGG
TTACCGATCTGCCGGGCCC -> TACCGATCTGCCGGGCCCA
TTACGCCGAGCTCCTCCGG -> TACGCCGAGCTCCTCCGGA
TTACTGAAGGATTAGGCTG -> TACTGAAGGATTAGGCTGT
TTACTTTAGCTCGGCTCCG -> TACTTTAGCTCGGCTCCGA
TTAGAGTATCGAAGTACGG -> TAGAGTATCGAAGTACGGG
TTAGCCGCGGGCAACGAGA -> TAGCCGCGGGCAACGAGAT
TTAGCTCGGCTCCGATTTC -> TAGCTCGGCTCCGATTTCG
TTAGGCTGTTGAACTAGGG -> TAGGCTGTTGAACTAGGGA
TTATATACACGTTTAAGGC -> TATATACACGTTTAAGGCG
TTATCCGCCACGCCGGCCA -> TATCCGCCACGCCGGCCAA
TTATGTTAACCGAATTTTC -> TATGTTAACCGAATTTTCA
TTATTAGAGTATCGAAGTA -> TATTAGAGTATCGAAGTAC
TTATTGCCGACAGATCAGT -> TATTGCCGACAGATCAGTC
TTATTTTAACAATGATCGG -> TATTTTAACAATGATCGGG
TTCAAAGACATTGGCACAA -> TCAAAGACATTGGCACAAC
TTCAAGAGCCCGCAGCCCA -> TCAAGAGCCCGCAGCCCAT
TTCACAACGGCAATGACTG -> TCACAACGGCAATGACTGG
TTCATACCGATTTCGAGCA -> TCATACCGATTTCGAGCAT
TTCATATGGCAATGAGAAG -> TCATATGGCAATGAGAAGT
TTCATCCCTCAACCATAGG -> TCATCCCTCAACCATAGGA
TTCATGGCATCTGGCAGTC -> TCATGGCATCTGGCAGTCT
TTCCAATGGCCGGCCGGGA -> TCCAATGGCCGGCCGGGAA
TTCCAGACATCGTAGGTTG -> TCCAGACATCGTAGGTTGA
TTCCCACTCGCGCTAGATT -> TCCCACTCGCGCTAGATTC
TTCCCAGGACGGGCATATA -> TCCCAGGACGGGCATATAC
TTCCGACACAAGCACTTCC -> TCCGACACAAGCACTTCCG
TTCCGAGACTACTTCACAA -> TCCGAGACTACTTCACAAC
TTCCTAGCCCGGTCTCTAA -> TCCTAGCCCGGTCTCTAAA
TTCCTGTGTTGCCCCCGAT -> TCCTGTGTTGCCCCCGATT
TTCCTTAATTGTGTCCGGA -> TCCTTAATTGTGTCCGGAA
TTCCTTGCGCTACGCTCAC -> TCCTTGCGCTACGCTCACA
TTCGACACAATGGCTGTAG -> TCGACACAATGGCTGTAGG
TTCGACGGGGTCGGGCGAT -> TCGACGGGGTCGGGCGATG
TTCGAGCATGTACAAACGG -> TCGAGCATGTACAAACGGA
TTCGAGCATGTACCTTGTC -> TCGAGCATGTACCTTGTCT
TTCGAGCATGTACGCTACG -> TCGAGCATGTACGCTACGA
TTCGAGCATGTACTTGATA -> TCGAGCATGTACTTGATAG
TTCGCCACCAATCAACTTC -> TCGCCACCAATCAACTTCC
TTCGCCATTATTGCCGACA -> TCGCCATTATTGCCGACAG
TTCGGATAAAAGGTACAAG -> TCGGATAAAAGGTACAAGC
TTCTAGATTCCCAGGACGG -> TCTAGATTCCCAGGACGGG
TTCTATACAAGTGAGTGGG -> TCTATACAAGTGAGTGGGA
TTCTCACTCGCTGCAGCTG -> TCTCACTCGCTGCAGCTGA
TTCTCGGGCGATTGCGTAA -> TCTCGGGCGATTGCGTAAG
TTCTCTGTCCACTTCATGG -> TCTCTGTCCACTTCATGGC
TTCTGGACGGCCTTGCAGA -> TCTGGACGGCCTTGCAGAG
TTCTTGGCACACTGATACT -> TCTTGGCACACTGATACTA
TTGAACTAGGGAGGCCGAG -> TGAACTAGGGAGGCCGAGC
TTGACCTTCGTTTAGCCTA -> TGACCTTCGTTTAGCCTAG
TTGACTCCCCTATGTATCT -> TGACTCCCCTATGTATCTA
TTGAGGTGCTGGCGCCATC -> TGAGGTGCTGGCGCCATCC
TTGAGGTGCTTTCCTTAAT -> TGAGGTGCTTTCCTTAATT
TTGAGGTTTGCTGTCGAAA -> TGAGGTTTGCTGTCGAAAC
TTGATAGCGGTTGGGCGGT -> TGATAGCGGTTGGGCGGTG
TTGATCGTACCGTCTTCGC -> TGATCGTACCGTCTTCGCC
TTGATTTGAGGTGCTGGCG -> TGATTTGAGGTGCTGGCGC
TTGCAGAGCTTCGCCACCA -> TGCAGAGCTTCGCCACCAA
TTGCCCCCGATTTCGAGCA -> TGCCCCCGATTTCGAGCAT
TTGCCGACAGATCAGTCCA -> TGCCGACAGATCAGTCCAT
TTGCGCTACGCTCACAGCG -> TGCGCTACGCTCACAGCGC
TTGCGTAAGTCGATACCTG -> TGCGTAAGTCGATACCTGC
TTGCGTAGGTAGTAGTTTT -> TGCGTAGGTAGTAGTTTTG
TTGCTACAGGATATGATTT -> TGCTACAGGATATGATTTG
TTGCTCTGCACCCTGCAAA -> TGCTCTGCACCCTGCAAAG
TTGCTGTCGAAACGAAGGC -> TGCTGTCGAAACGAAGGCA
TTGCTTCCAGACATCGTAG -> TGCTTCCAGACATCGTAGG
TTGGACCGGGTAGCGGTCC -> TGGACCGGGTAGCGGTCCC
TTGGCACAACTCAGGTAGT -> TGGCACAACTCAGGTAGTG
TTGGCACACTGATACTAGC -> TGGCACACTGATACTAGCA
TTGGGCGGTGTACCATCAA -> TGGGCGGTGTACCATCAAC,TGGGCGGTGTACCATCAAC
TTGTCAGCACCCGCCCTTC -> TGTCAGCACCCGCCCTTCG
TTGTCCTCCGACCTAGAGG -> TGTCCTCCGACCTAGAGGG
TTGTCTGTGGTGGGCGGTG -> TGTCTGTGGTGGGCGGTGT
TTGTGCATAAGGGTATTGA -> TGTGCATAAGGGTATTGAG
TTGTGTCCGGAAGCATAGA -> TGTGTCCGGAAGCATAGAC
TTGTGTGTGAATTCGACGG -> TGTGTGTGAATTCGACGGG
TTTAACAATGATCGGGTGC -> TTAACAATGATCGGGTGCA
TTTAAGGCGTAATGACTTC -> TTAAGGCGTAATGACTTCA
TTTACGCCGAGCTCCTCCG -> TTACGCCGAGCTCCTCCGG
TTTAGCCGCGGGCAACGAG -> TTAGCCGCGGGCAACGAGA
TTTAGCTCGGCTCCGATTT -> TTAGCTCGGCTCCGATTTC
TTTATCCGCCACGCCGGCC -> TTATCCGCCACGCCGGCCA
TTTATTAGAGTATCGAAGT -> TTATTAGAGTATCGAAGTA
TTTCATACCGATTTCGAGC -> TTCATACCGATTTCGAGCA
TTTCATATGGCAATGAGAA -> TTCATATGGCAATGAGAAG
TTTCCTTAATTGTGTCCGG -> TTCCTTAATTGTGTCCGGA
TTTCGACACAATGGCTGTA -> TTCGACACAATGGCTGTAG
TTTCGAGCATGTACAAACG -> TTCGAGCATGTACAAACGG
TTTCGAGCATGTACCTTGT -> TTCGAGCATGTACCTTGTC
TTTCGAGCATGTACGCTAC -> TTCGAGCATGTACGCTACG
TTTCGAGCATGTACTTGAT -> TTCGAGCATGTACTTGATA
TTTCTCACTCGCTGCAGCT -> TTCTCACTCGCTGCAGCTG
TTTCTTGGCACACTGATAC -> TTCTTGGCACACTGATACT
TTTGACTCCCCTATGTATC -> TTGACTCCCCTATGTATCT
TTTGAGGTGCTGGCGCCAT -> TTGAGGTGCTGGCGCCATC
TTTGCTACAGGATATGATT -> TTGCTACAGGATATGATTT
TTTGCTGTCGAAACGAAGG -> TTGCTGTCGAAACGAAGGC
TTTGTCCTCCGACCTAGAG -> TTGTCCTCCGACCTAGAGG
TTTTAACAATGATCGGGTG -> TTTAACAATGATCGGGTGC
TTTTAGCCGCGGGCAACGA -> TTTAGCCGCGGGCAACGAG
TTTTCATATGGCAATGAGA -> TTTCATATGGCAATGAGAA
TTTTCTTGGCACACTGATA -> TTTCTTGGCACACTGATAC
TTTTGCTACAGGATATGAT -> TTTGCTACAGGATATGATT
TTTTGTCCTCCGACCTAGA -> TTTGTCCTCCGACCTAGAG
TTTTTGTCCTCCGACCTAG -> TTTTGTCCTCCGACCTAGA